Z均分子量  	<br><font color=blue size=4>Z均分子量  </font>\n<br>Z(Zaverage)-average molecular weight, Z-molar mass\n
α cellulose  	<br><font color=blue size=4>α cellulose  </font>\n<br>α纤维素\n
α纤维素  	<br><font color=blue size=4>α纤维素  </font>\n<br>α cellulose\n
β cellulose  	<br><font color=blue size=4>β cellulose  </font>\n<br>β纤维素\n
β纤维素  	<br><font color=blue size=4>β纤维素  </font>\n<br>β cellulose\n
γ cellulose  	<br><font color=blue size=4>γ cellulose  </font>\n<br>γ纤维素\n
γ纤维素  	<br><font color=blue size=4>γ纤维素  </font>\n<br>γ cellulose\n
θ态  	<br><font color=blue size=4>θ态  </font>\n<br>theta state\n
θ温度  	<br><font color=blue size=4>θ温度  </font>\n<br>theta temperature\n
θ溶剂  	<br><font color=blue size=4>θ溶剂  </font>\n<br>theta solvent\n
μ氧桥双金属烷氧化物催化剂  	<br><font color=blue size=4>μ氧桥双金属烷氧化物催化剂  </font>\n<br>bimetallic μ-oxo alkoxides catalyst\n
χ-parameter  	<br><font color=blue size=4>χ-parameter  </font>\n<br>χ(相互作用)参数\n
χ(相互作用)参数  	<br><font color=blue size=4>χ(相互作用)参数  </font>\n<br>χ-parameter\n
ω-polymer  	<br><font color=blue size=4>ω-polymer  </font>\n<br>ω橡胶\n
ω聚合物  	<br><font color=blue size=4>ω聚合物  </font>\n<br>ω-polymer\n
丁吡橡胶  	<br><font color=blue size=4>丁吡橡胶  </font>\n<br>pyridine butadiene rubber\n
丁基橡胶  	<br><font color=blue size=4>丁基橡胶  </font>\n<br>butyl rubber\n
丁腈橡胶  	<br><font color=blue size=4>丁腈橡胶  </font>\n<br>butadiene-acrylonitrile rubber, nitrile rubber\n
丁苯橡胶  	<br><font color=blue size=4>丁苯橡胶  </font>\n<br>styrene butadiene rubber, SBR\n
三元乙丙橡胶  	<br><font color=blue size=4>三元乙丙橡胶  </font>\n<br>ethylene propylene terpolymer, EPT, ethylene propylene diene monomer, EPDM, 又称“乙丙三元橡胶”\n
三元共聚合  	<br><font color=blue size=4>三元共聚合  </font>\n<br>ternary copolymerization\n
三元共聚物  	<br><font color=blue size=4>三元共聚物  </font>\n<br>terpolymer\n
三单元组  	<br><font color=blue size=4>三单元组  </font>\n<br>triad\n
三嗪氟橡胶  	<br><font color=blue size=4>三嗪氟橡胶  </font>\n<br>fluorinated triazine rubber\n
三官能引发剂  	<br><font color=blue size=4>三官能引发剂  </font>\n<br>trifunctional initiator\n
三官能［基］单体  	<br><font color=blue size=4>三官能［基］单体  </font>\n<br>trifunctional monomer\n
三嵌段共聚物  	<br><font color=blue size=4>三嵌段共聚物  </font>\n<br>triblock copolymer\n
三聚氰胺树脂  	<br><font color=blue size=4>三聚氰胺树脂  </font>\n<br>Aminotriazine resin\n
三聚氰胺-甲醛树脂  	<br><font color=blue size=4>三聚氰胺-甲醛树脂  </font>\n<br>melamine-formaldehyde resin, melamine resin\n
三聚体  	<br><font color=blue size=4>三聚体  </font>\n<br>trimer\n
三叶橡胶  	<br><font color=blue size=4>三叶橡胶  </font>\n<br>Hevea\n
不可回复形变  	<br><font color=blue size=4>不可回复形变  </font>\n<br>irrecoverable deformation\n
不均匀硫化  	<br><font color=blue size=4>不均匀硫化  </font>\n<br>heterogeneous vulcanization\n
不对称立体选择性聚合  	<br><font color=blue size=4>不对称立体选择性聚合  </font>\n<br>asymmetric stereoselective polymerization\n
不对称诱导聚合  	<br><font color=blue size=4>不对称诱导聚合  </font>\n<br>asymmetric induction polymerization\n
不对称选择性聚合  	<br><font color=blue size=4>不对称选择性聚合  </font>\n<br>asymmetric selective polymerization\n
不死的聚合  	<br><font color=blue size=4>不死的聚合  </font>\n<br>immortal polymerization\n
不混容性  	<br><font color=blue size=4>不混容性  </font>\n<br>immiscibility\n
不兼容性  	<br><font color=blue size=4>不兼容性  </font>\n<br>incompatibility\n
不良溶剂  	<br><font color=blue size=4>不良溶剂  </font>\n<br>poor solvent\n
不饱和橡胶  	<br><font color=blue size=4>不饱和橡胶  </font>\n<br>unsaturated rubber\n
不饱和聚酯  	<br><font color=blue size=4>不饱和聚酯  </font>\n<br>unsaturated polyester\n
丙二烯聚合物  	<br><font color=blue size=4>丙二烯聚合物  </font>\n<br>allene polymer\n
丙烯腈-丁二烯-苯乙烯树脂  	<br><font color=blue size=4>丙烯腈-丁二烯-苯乙烯树脂  </font>\n<br>acrylonitrile-butadiene-styrene resin, 简称“ABS树脂”\n
丙烯腈-苯乙烯树脂  	<br><font color=blue size=4>丙烯腈-苯乙烯树脂  </font>\n<br>acrylonitrile styrene resin (AS)\n
丙烯酸酯橡胶  	<br><font color=blue size=4>丙烯酸酯橡胶  </font>\n<br>acrylate rubber\n
丙烯酸[酯]类树脂  	<br><font color=blue size=4>丙烯酸[酯]类树脂  </font>\n<br>acrylic resin\n
丙烯酸[酯]类聚合物  	<br><font color=blue size=4>丙烯酸[酯]类聚合物  </font>\n<br>acrylic polymer\n
丙烯醛类聚合物  	<br><font color=blue size=4>丙烯醛类聚合物  </font>\n<br>acrolein polymer\n
丙纶  	<br><font color=blue size=4>丙纶  </font>\n<br>polypropylene fiber\n
丙阶酚醛树脂  	<br><font color=blue size=4>丙阶酚醛树脂  </font>\n<br>resite, 又叫“不溶不熔酚醛树脂”\n
中空纤维  	<br><font color=blue size=4>中空纤维  </font>\n<br>hollow fiber\n
串晶结构  	<br><font color=blue size=4>串晶结构  </font>\n<br>shish-kebab structure\n
主结晶  	<br><font color=blue size=4>主结晶  </font>\n<br>primary crystallization\n
主链  	<br><font color=blue size=4>主链  </font>\n<br>chain backbone\n
主链型液晶聚合物  	<br><font color=blue size=4>主链型液晶聚合物  </font>\n<br>main chain liquid crystalline polymer\n
乙炔类聚合物  	<br><font color=blue size=4>乙炔类聚合物  </font>\n<br>acetylenic polymer\n
乙烯-乙酸乙烯酯共聚物  	<br><font color=blue size=4>乙烯-乙酸乙烯酯共聚物  </font>\n<br>ethylene vinyl acetate copolymer (EVA)\n
乙烯基单体  	<br><font color=blue size=4>乙烯基单体  </font>\n<br>vinyl monomer\n
乙烯基聚合  	<br><font color=blue size=4>乙烯基聚合  </font>\n<br>vinyl polymerization\n
乙烯基聚合物  	<br><font color=blue size=4>乙烯基聚合物  </font>\n<br>vinyl polymer\n
乙酸纤维素  	<br><font color=blue size=4>乙酸纤维素  </font>\n<br>cellulose acetate\n
乙阶酚醛树脂  	<br><font color=blue size=4>乙阶酚醛树脂  </font>\n<br>resitol, 又叫“半熔酚醛树脂”\n
乳液纺丝  	<br><font color=blue size=4>乳液纺丝  </font>\n<br>emulsion spinning\n
乳液聚合  	<br><font color=blue size=4>乳液聚合  </font>\n<br>emulsion polymerization\n
乳液闪蒸纺丝法  	<br><font color=blue size=4>乳液闪蒸纺丝法  </font>\n<br>emulsion flash spinning process\n
乳聚丁苯橡胶  	<br><font color=blue size=4>乳聚丁苯橡胶  </font>\n<br>emulsion polymerized butadiene styrene rubber(ESBR)\n
二乙炔聚合物  	<br><font color=blue size=4>二乙炔聚合物  </font>\n<br>diacetylene polymer\n
二元乙丙橡胶  	<br><font color=blue size=4>二元乙丙橡胶  </font>\n<br>ethylene propylene rubber, EPR, ethylene propylenecopolymer, ethylene propylene monomer, EPM, 又称“乙丙二元橡胶”\n
二元共聚合  	<br><font color=blue size=4>二元共聚合  </font>\n<br>binary copolymerization\n
二元共聚物  	<br><font color=blue size=4>二元共聚物  </font>\n<br>binary copolymer\n
二单元组  	<br><font color=blue size=4>二单元组  </font>\n<br>diad\n
二嵌段共聚物  	<br><font color=blue size=4>二嵌段共聚物  </font>\n<br>diblock copolymer\n
二烯丙基聚合物  	<br><font color=blue size=4>二烯丙基聚合物  </font>\n<br>diallyl polymer\n
二烯单体  	<br><font color=blue size=4>二烯单体  </font>\n<br>diene monomer\n
二甲基硅橡胶  	<br><font color=blue size=4>二甲基硅橡胶  </font>\n<br>dimethyl silicone rubber\n
二聚体  	<br><font color=blue size=4>二聚体  </font>\n<br>dimer\n
互穿聚合物网络  	<br><font color=blue size=4>互穿聚合物网络  </font>\n<br>interpenetrating polymer networks, IPN\n
五单元组  	<br><font color=blue size=4>五单元组  </font>\n<br>pentad\n
亚硝基氟橡胶  	<br><font color=blue size=4>亚硝基氟橡胶  </font>\n<br>nitrosofluoro rubber\n
亚稳态  	<br><font color=blue size=4>亚稳态  </font>\n<br>metastable state\n
亚稳相分离  	<br><font color=blue size=4>亚稳相分离  </font>\n<br>spinodal decomposition, bimodal decomposition\n
交叉增长  	<br><font color=blue size=4>交叉增长  </font>\n<br>cross propagation\n
交叉终止  	<br><font color=blue size=4>交叉终止  </font>\n<br>cross termination\n
交替共聚合  	<br><font color=blue size=4>交替共聚合  </font>\n<br>alternating copolymerization\n
交替共聚物  	<br><font color=blue size=4>交替共聚物  </font>\n<br>alternating copolymer\n
交联  	<br><font color=blue size=4>交联  </font>\n<br>crosslinking\n
交联密度  	<br><font color=blue size=4>交联密度  </font>\n<br>crosslinking density\n
交联度  	<br><font color=blue size=4>交联度  </font>\n<br>degree of crosslinking\n
交联指数  	<br><font color=blue size=4>交联指数  </font>\n<br>crosslinking index\n
交联聚合物  	<br><font color=blue size=4>交联聚合物  </font>\n<br>crosslinked polymer\n
人工老化  	<br><font color=blue size=4>人工老化  </font>\n<br>artificial ageing\n
介电弛豫时间  	<br><font color=blue size=4>介电弛豫时间  </font>\n<br>dielectric relaxation time\n
介电损耗因子  	<br><font color=blue size=4>介电损耗因子  </font>\n<br>dielectric dissipation factor\n
介电损耗常数  	<br><font color=blue size=4>介电损耗常数  </font>\n<br>dielectric loss constant\n
仿生高分子  	<br><font color=blue size=4>仿生高分子  </font>\n<br>biomimetic polymer\n
伸展链晶体  	<br><font color=blue size=4>伸展链晶体  </font>\n<br>extended-chain crystal\n
伸直长度  	<br><font color=blue size=4>伸直长度  </font>\n<br>contour length\n
伸长态  	<br><font color=blue size=4>伸长态  </font>\n<br>elongation\n
位力系数  	<br><font color=blue size=4>位力系数  </font>\n<br>Virial coefficient, 曾用名“维里系数”\n
低密度聚乙烯  	<br><font color=blue size=4>低密度聚乙烯  </font>\n<br>low density polyethylene, LDPE\n
低聚反应  	<br><font color=blue size=4>低聚反应  </font>\n<br>oligomerization\n
低聚物  	<br><font color=blue size=4>低聚物  </font>\n<br>oligomer\n
低聚甲醛  	<br><font color=blue size=4>低聚甲醛  </font>\n<br>paraformaldehyde 又称“多聚甲醛”\n
促进硫化  	<br><font color=blue size=4>促进硫化  </font>\n<br>accelerated sulfur vulcanization\n
假塑性  	<br><font color=blue size=4>假塑性  </font>\n<br>pseudoplastic\n
假正离子活性聚合  	<br><font color=blue size=4>假正离子活性聚合  </font>\n<br>pseudo cationic living polymerization\n
假正离子聚合  	<br><font color=blue size=4>假正离子聚合  </font>\n<br>pseudo cationic polymerization\n
假终止  	<br><font color=blue size=4>假终止  </font>\n<br>pseudotermination\n
偏［二］取代乙烯单体  	<br><font color=blue size=4>偏［二］取代乙烯单体  </font>\n<br>vinylidene monomer\n
侧基反应  	<br><font color=blue size=4>侧基反应  </font>\n<br>reaction of pendant group\n
侧链型液晶聚合物  	<br><font color=blue size=4>侧链型液晶聚合物  </font>\n<br>side chain liquid crystalline polymer\n
偶合终止  	<br><font color=blue size=4>偶合终止  </font>\n<br>coupling termination\n
偶氮类聚合物  	<br><font color=blue size=4>偶氮类聚合物  </font>\n<br>azo polymer\n
偶氮［类］引发剂  	<br><font color=blue size=4>偶氮［类］引发剂  </font>\n<br>azo type initiator\n
偶联剂  	<br><font color=blue size=4>偶联剂  </font>\n<br>coupling agent\n
偶联聚合  	<br><font color=blue size=4>偶联聚合  </font>\n<br>coupling polymerization\n
催干剂  	<br><font color=blue size=4>催干剂  </font>\n<br>drier\n
传递成型  	<br><font color=blue size=4>传递成型  </font>\n<br>transfer molding\n
储能模量  	<br><font color=blue size=4>储能模量  </font>\n<br>storage modulus\n
元素高分子  	<br><font color=blue size=4>元素高分子  </font>\n<br>element polymer\n
充气吹胀  	<br><font color=blue size=4>充气吹胀  </font>\n<br>inflation\n
充油橡胶  	<br><font color=blue size=4>充油橡胶  </font>\n<br>oil-extended rubber\n
光交联  	<br><font color=blue size=4>光交联  </font>\n<br>photocrosslinking\n
光交联聚合物  	<br><font color=blue size=4>光交联聚合物  </font>\n<br>photocrosslinkable polymer\n
光刻胶  	<br><font color=blue size=4>光刻胶  </font>\n<br>photoresist\n
光固化  	<br><font color=blue size=4>光固化  </font>\n<br>photo-cure\n
光固化聚合物  	<br><font color=blue size=4>光固化聚合物  </font>\n<br>photocureable polymer\n
光导纤维  	<br><font color=blue size=4>光导纤维  </font>\n<br>photoconductive fiber\n
光屏蔽剂  	<br><font color=blue size=4>光屏蔽剂  </font>\n<br>light screener\n
光引发聚合  	<br><font color=blue size=4>光引发聚合  </font>\n<br>light initiated polymerization\n
光引发转移终止剂  	<br><font color=blue size=4>光引发转移终止剂  </font>\n<br>photoiniferter\n
光弹性聚合物  	<br><font color=blue size=4>光弹性聚合物  </font>\n<br>photoelastic polymer\n
光敏引发剂  	<br><font color=blue size=4>光敏引发剂  </font>\n<br>photoinitiator\n
光敏聚合  	<br><font color=blue size=4>光敏聚合  </font>\n<br>photosensitized polymerization\n
光敏聚合物  	<br><font color=blue size=4>光敏聚合物  </font>\n<br>photosensitive polymer\n
光氧化降解  	<br><font color=blue size=4>光氧化降解  </font>\n<br>photo oxidative degradation\n
光活性聚合物  	<br><font color=blue size=4>光活性聚合物  </font>\n<br>optical active polymer\n
光稳定剂  	<br><font color=blue size=4>光稳定剂  </font>\n<br>light stabilizer, photostabilizer\n
光老化  	<br><font color=blue size=4>光老化  </font>\n<br>photoageing\n
光致抗蚀剂  	<br><font color=blue size=4>光致抗蚀剂  </font>\n<br>photoresist\n
光致发光聚合物  	<br><font color=blue size=4>光致发光聚合物  </font>\n<br>photoluminescence polymer\n
光降解  	<br><font color=blue size=4>光降解  </font>\n<br>photodegradation\n
光降解聚合物  	<br><font color=blue size=4>光降解聚合物  </font>\n<br>photodegradable polymer\n
光[电]导聚合物  	<br><font color=blue size=4>光[电]导聚合物  </font>\n<br>photoconductive polymer\n
光响应高分子  	<br><font color=blue size=4>光响应高分子  </font>\n<br>photoresponsive polymer\n
光［致］聚合  	<br><font color=blue size=4>光［致］聚合  </font>\n<br>photo polymerization\n
内增塑作用  	<br><font color=blue size=4>内增塑作用  </font>\n<br>internal plasticization\n
内脱模剂  	<br><font color=blue size=4>内脱模剂  </font>\n<br>internal releasing agent\n
全取向丝  	<br><font color=blue size=4>全取向丝  </font>\n<br>fully oriented yarn\n
全同立构聚丙烯  	<br><font color=blue size=4>全同立构聚丙烯  </font>\n<br>isotactic polypropylene(iPP)\n
全同立构聚合  	<br><font color=blue size=4>全同立构聚合  </font>\n<br>isospecific polymerization\n
全同立构聚合物  	<br><font color=blue size=4>全同立构聚合物  </font>\n<br>isotactic polymer\n
全同立构[规整]度  	<br><font color=blue size=4>全同立构[规整]度  </font>\n<br>isotacticity\n
全同间同等量聚合物  	<br><font color=blue size=4>全同间同等量聚合物  </font>\n<br>equitactic polymer\n
全纤维素  	<br><font color=blue size=4>全纤维素  </font>\n<br>hollocellulose\n
两性聚电解质  	<br><font color=blue size=4>两性聚电解质  </font>\n<br>polyampholyte, polyamphoteric electrolyte\n
两性离子聚合  	<br><font color=blue size=4>两性离子聚合  </font>\n<br>zwitterion polymerization\n
两亲嵌段共聚物  	<br><font color=blue size=4>两亲嵌段共聚物  </font>\n<br>amphiphilic block copolymer\n
两亲聚合物  	<br><font color=blue size=4>两亲聚合物  </font>\n<br>amphiphilic polymer\n
共引发剂  	<br><font color=blue size=4>共引发剂  </font>\n<br>coinitiator\n
共挤出  	<br><font color=blue size=4>共挤出  </font>\n<br>coextrusion\n
共挤吹塑  	<br><font color=blue size=4>共挤吹塑  </font>\n<br>coextrusion blow molding\n
共注塑  	<br><font color=blue size=4>共注塑  </font>\n<br>coinjection molding\n
共混  	<br><font color=blue size=4>共混  </font>\n<br>blend\n
共混纺丝  	<br><font color=blue size=4>共混纺丝  </font>\n<br>blended spinning\n
共纺  	<br><font color=blue size=4>共纺  </font>\n<br>cospinning\n
共缩聚  	<br><font color=blue size=4>共缩聚  </font>\n<br>copolycondensation\n
共缩聚物  	<br><font color=blue size=4>共缩聚物  </font>\n<br>intercondensation polymer\n
共聚合  	<br><font color=blue size=4>共聚合  </font>\n<br>copolymerization\n
共聚合方程  	<br><font color=blue size=4>共聚合方程  </font>\n<br>copolymerization equation\n
共聚单体  	<br><font color=blue size=4>共聚单体  </font>\n<br>comonomer\n
共聚物  	<br><font color=blue size=4>共聚物  </font>\n<br>copolymer\n
共聚甲醛  	<br><font color=blue size=4>共聚甲醛  </font>\n<br>copolyoxymethylene\n
共聚酯  	<br><font color=blue size=4>共聚酯  </font>\n<br>copolyester\n
共聚醚  	<br><font color=blue size=4>共聚醚  </font>\n<br>copolyether\n
共轭单体  	<br><font color=blue size=4>共轭单体  </font>\n<br>conjugated monomer\n
共轭聚合物  	<br><font color=blue size=4>共轭聚合物  </font>\n<br>conjugated polymer\n
再引发  	<br><font color=blue size=4>再引发  </font>\n<br>reinitiation\n
再生胶  	<br><font color=blue size=4>再生胶  </font>\n<br>reclaimed rubber\n
再聚合  	<br><font color=blue size=4>再聚合  </font>\n<br>repolymerization\n
冷拉伸  	<br><font color=blue size=4>冷拉伸  </font>\n<br>cold drawing, cold stretching\n
冷流  	<br><font color=blue size=4>冷流  </font>\n<br>cold flow\n
冷轧  	<br><font color=blue size=4>冷轧  </font>\n<br>cold rolling\n
凝聚  	<br><font color=blue size=4>凝聚  </font>\n<br>coalescence\n
凝聚态  	<br><font color=blue size=4>凝聚态  </font>\n<br>condensed state\n
凝聚相  	<br><font color=blue size=4>凝聚相  </font>\n<br>condensed phase\n
凝聚缠结  	<br><font color=blue size=4>凝聚缠结  </font>\n<br>cohesional entanglement\n
凝聚过程  	<br><font color=blue size=4>凝聚过程  </font>\n<br>condensing process\n
凝胶  	<br><font color=blue size=4>凝胶  </font>\n<br>gel\n
凝胶效应  	<br><font color=blue size=4>凝胶效应  </font>\n<br>gel effect\n
凝胶纺[丝]  	<br><font color=blue size=4>凝胶纺[丝]  </font>\n<br>gel spinning\n
凝胶色谱法  	<br><font color=blue size=4>凝胶色谱法  </font>\n<br>gel chromatography\n
凝胶点  	<br><font color=blue size=4>凝胶点  </font>\n<br>gel point\n
分子动力学模拟  	<br><font color=blue size=4>分子动力学模拟  </font>\n<br>molecular dynamics simulation\n
分子成核作用  	<br><font color=blue size=4>分子成核作用  </font>\n<br>molecular nucleation\n
分子组合  	<br><font color=blue size=4>分子组合  </font>\n<br>molecular assembly\n
分子组装  	<br><font color=blue size=4>分子组装  </font>\n<br>molecular assembly\n
分子复合材料  	<br><font color=blue size=4>分子复合材料  </font>\n<br>molecular composite\n
分子量分布  	<br><font color=blue size=4>分子量分布  </font>\n<br>molecular weight distribution，MWD\n
分子量排除极限  	<br><font color=blue size=4>分子量排除极限  </font>\n<br>molecular weight exclusion limit\n
分批聚合  	<br><font color=blue size=4>分批聚合  </font>\n<br>batch polymerization\n
分散剂  	<br><font color=blue size=4>分散剂  </font>\n<br>dispersant agent\n
分散聚合  	<br><font color=blue size=4>分散聚合  </font>\n<br>dispersion polymerization\n
分段梯形聚合物  	<br><font color=blue size=4>分段梯形聚合物  </font>\n<br>step ladder polymer\n
分级  	<br><font color=blue size=4>分级  </font>\n<br>fractionation\n
分聚  	<br><font color=blue size=4>分聚  </font>\n<br>segregation\n
初生纤维  	<br><font color=blue size=4>初生纤维  </font>\n<br>as-formed fiber\n
初级自由基终止  	<br><font color=blue size=4>初级自由基终止  </font>\n<br>primary radical termination\n
刷状聚合物  	<br><font color=blue size=4>刷状聚合物  </font>\n<br>brush polymer\n
前末端基效应  	<br><font color=blue size=4>前末端基效应  </font>\n<br>penultimate effect\n
刚性链  	<br><font color=blue size=4>刚性链  </font>\n<br>rigid chain\n
刚性链聚合物  	<br><font color=blue size=4>刚性链聚合物  </font>\n<br>rigid chain polymer\n
刚-柔嵌段共聚物  	<br><font color=blue size=4>刚-柔嵌段共聚物  </font>\n<br>rod coil block copolymer\n
刚棒高分子  	<br><font color=blue size=4>刚棒高分子  </font>\n<br>rigid rod polymer\n
剥离强度  	<br><font color=blue size=4>剥离强度  </font>\n<br>peeling strength\n
剩余伸长  	<br><font color=blue size=4>剩余伸长  </font>\n<br>residual stretch\n
剩余应力  	<br><font color=blue size=4>剩余应力  </font>\n<br>residual stress\n
剩余变形  	<br><font color=blue size=4>剩余变形  </font>\n<br>residual deformation\n
剪切强度  	<br><font color=blue size=4>剪切强度  </font>\n<br>shear strength\n
剪切应力  	<br><font color=blue size=4>剪切应力  </font>\n<br>shear stress\n
剪切应变  	<br><font color=blue size=4>剪切应变  </font>\n<br>shear strain\n
剪切模量  	<br><font color=blue size=4>剪切模量  </font>\n<br>shear modulus\n
剪切变稀  	<br><font color=blue size=4>剪切变稀  </font>\n<br>shear thinning\n
剪切黏度  	<br><font color=blue size=4>剪切黏度  </font>\n<br>shear viscosity\n
力化学降解  	<br><font color=blue size=4>力化学降解  </font>\n<br>mechanochemical degradation\n
力学破坏  	<br><font color=blue size=4>力学破坏  </font>\n<br>mechanical failure\n
功能砜料  	<br><font color=blue size=4>功能砜料  </font>\n<br>functional coating\n
功能纤维  	<br><font color=blue size=4>功能纤维  </font>\n<br>functional fiber\n
功能高分子  	<br><font color=blue size=4>功能高分子  </font>\n<br>functional polymer\n
加宽函数  	<br><font color=blue size=4>加宽函数  </font>\n<br>spreading function\n
加工  	<br><font color=blue size=4>加工  </font>\n<br>processing\n
加工性  	<br><font color=blue size=4>加工性  </font>\n<br>processability\n
加成断裂链转移  	<br><font color=blue size=4>加成断裂链转移  </font>\n<br>addition fragmentation chain transfer\n
加[成]聚[合]物  	<br><font color=blue size=4>加[成]聚[合]物  </font>\n<br>addition polymer\n
加聚  	<br><font color=blue size=4>加聚  </font>\n<br>addition polymerization\n
加速老化  	<br><font color=blue size=4>加速老化  </font>\n<br>accelerated ageing\n
动力学链长  	<br><font color=blue size=4>动力学链长  </font>\n<br>kinetic chain length\n
动态光散射  	<br><font color=blue size=4>动态光散射  </font>\n<br>dynamic light scattering\n
动态力学行为  	<br><font color=blue size=4>动态力学行为  </font>\n<br>dynamic mechanical behavior\n
动态硫化  	<br><font color=blue size=4>动态硫化  </font>\n<br>dynamic vulcanization\n
动态转变  	<br><font color=blue size=4>动态转变  </font>\n<br>dynamic transition\n
动态黏度  	<br><font color=blue size=4>动态黏度  </font>\n<br>dynamic viscosity\n
动态黏弹性  	<br><font color=blue size=4>动态黏弹性  </font>\n<br>dynamic viscoelasticity\n
包模成型  	<br><font color=blue size=4>包模成型  </font>\n<br>drape molding\n
化学交联  	<br><font color=blue size=4>化学交联  </font>\n<br>chemical crosslinking\n
化学发泡  	<br><font color=blue size=4>化学发泡  </font>\n<br>chemical foam\n
化学发泡剂  	<br><font color=blue size=4>化学发泡剂  </font>\n<br>chemical foaming agent\n
化学纤维  	<br><font color=blue size=4>化学纤维  </font>\n<br>chemical fiber\n
化学降解  	<br><font color=blue size=4>化学降解  </font>\n<br>chemical degradation\n
半互穿聚合物网络  	<br><font color=blue size=4>半互穿聚合物网络  </font>\n<br>semi-interpenetrating polymer network(SIPN)\n
半合成纤维  	<br><font color=blue size=4>半合成纤维  </font>\n<br>semi-synthetic fiber\n
半柔性链聚合物  	<br><font color=blue size=4>半柔性链聚合物  </font>\n<br>semi- flexible chain polymer\n
半结晶聚合物  	<br><font color=blue size=4>半结晶聚合物  </font>\n<br>semi-crystalline polymer\n
半透膜  	<br><font color=blue size=4>半透膜  </font>\n<br>semipermeable membrane\n
半连续聚合  	<br><font color=blue size=4>半连续聚合  </font>\n<br>semicontinuous polymerization\n
卷曲构象  	<br><font color=blue size=4>卷曲构象  </font>\n<br>coiled conformation\n
原位聚合  	<br><font color=blue size=4>原位聚合  </font>\n<br>in situ polymerization\n
原位复合材料  	<br><font color=blue size=4>原位复合材料  </font>\n<br>in situ composite\n
原子转移自由基聚合  	<br><font color=blue size=4>原子转移自由基聚合  </font>\n<br>atom transfer radical polymerization，ATRP\n
原纤  	<br><font color=blue size=4>原纤  </font>\n<br>fibril\n
厌氧黏合剂  	<br><font color=blue size=4>厌氧黏合剂  </font>\n<br>anaerobic adhesive\n
反向原子转移自由基聚合  	<br><font color=blue size=4>反向原子转移自由基聚合  </font>\n<br>reverse atom transfer radical polymerization， RATRP\n
反式有规聚合物  	<br><font color=blue size=4>反式有规聚合物  </font>\n<br>transtactic polymer\n
反应性加工  	<br><font color=blue size=4>反应性加工  </font>\n<br>reactive processing\n
反应性挤塑  	<br><font color=blue size=4>反应性挤塑  </font>\n<br>reactive extrusion\n
反应性热熔胶  	<br><font color=blue size=4>反应性热熔胶  </font>\n<br>reactive heat-melting adhesive\n
反应性聚合物  	<br><font color=blue size=4>反应性聚合物  </font>\n<br>reactive polymer\n
反应注射成型  	<br><font color=blue size=4>反应注射成型  </font>\n<br>reaction injection molding, RIM\n
反应粘合  	<br><font color=blue size=4>反应粘合  </font>\n<br>reaction bonding\n
反应纺丝  	<br><font color=blue size=4>反应纺丝  </font>\n<br>reaction spinning\n
反渗透膜  	<br><font color=blue size=4>反渗透膜  </font>\n<br>Reverse osmosis membrance\n
反相乳液聚合  	<br><font color=blue size=4>反相乳液聚合  </font>\n<br>inverse emulsion polymerization\n
反相分散聚合  	<br><font color=blue size=4>反相分散聚合  </font>\n<br>inverse dispersion polymerization\n
反相悬浮聚合  	<br><font color=blue size=4>反相悬浮聚合  </font>\n<br>reversed phase suspension polymerization\n
反［式］-1,4-聚丁二烯  	<br><font color=blue size=4>反［式］-1,4-聚丁二烯  </font>\n<br>trans-1,4-polybutadiene\n
反［式］-1,4-聚异戊二烯  	<br><font color=blue size=4>反［式］-1,4-聚异戊二烯  </font>\n<br>trans-1,4-polyisoprene\n
取向度  	<br><font color=blue size=4>取向度  </font>\n<br>degree of orientation\n
受限态  	<br><font color=blue size=4>受限态  </font>\n<br>confined state\n
受限链  	<br><font color=blue size=4>受限链  </font>\n<br>confined chain\n
古塔波胶  	<br><font color=blue size=4>古塔波胶  </font>\n<br>Gutta percha\n
可控自由基聚合  	<br><font color=blue size=4>可控自由基聚合  </font>\n<br>controlled radical polymerization，CRP\n
可纺性  	<br><font color=blue size=4>可纺性  </font>\n<br>spinnability\n
可逆凝胶  	<br><font color=blue size=4>可逆凝胶  </font>\n<br>reversible gel\n
可逆加成断裂链转移  	<br><font color=blue size=4>可逆加成断裂链转移  </font>\n<br>reversible addition fragmentation chain transfer，RAFT\n
可逆形变  	<br><font color=blue size=4>可逆形变  </font>\n<br>reversible deformation\n
各向异性膜  	<br><font color=blue size=4>各向异性膜  </font>\n<br>anisotropic membrane\n
合成橡胶  	<br><font color=blue size=4>合成橡胶  </font>\n<br>synthetic rubber\n
合成纤维  	<br><font color=blue size=4>合成纤维  </font>\n<br>synthetic fiber\n
合成聚合物  	<br><font color=blue size=4>合成聚合物  </font>\n<br>synthetic polymer\n
同种增长  	<br><font color=blue size=4>同种增长  </font>\n<br>homopropagation\n
同轴挤塑  	<br><font color=blue size=4>同轴挤塑  </font>\n<br>coaxial extrusion\n
向列相  	<br><font color=blue size=4>向列相  </font>\n<br>nematic phase\n
吸水性聚合物  	<br><font color=blue size=4>吸水性聚合物  </font>\n<br>water absorbent polymer\n
吸附树脂  	<br><font color=blue size=4>吸附树脂  </font>\n<br>polymeric adsorbent\n
吸附聚合  	<br><font color=blue size=4>吸附聚合  </font>\n<br>adsorption polymerization\n
吹塑  	<br><font color=blue size=4>吹塑  </font>\n<br>blow molding\n
吹胀挤塑  	<br><font color=blue size=4>吹胀挤塑  </font>\n<br>blown extrusion\n
呋喃树脂  	<br><font color=blue size=4>呋喃树脂  </font>\n<br>furan resin\n
周期共聚物  	<br><font color=blue size=4>周期共聚物  </font>\n<br>periodic copolymer\n
哈金斯公式  	<br><font color=blue size=4>哈金斯公式  </font>\n<br>Huggins equation\n
哈金斯系数  	<br><font color=blue size=4>哈金斯系数  </font>\n<br>Huggins coefficient\n
单分子终止  	<br><font color=blue size=4>单分子终止  </font>\n<br>unimolecular termination\n
单分散性  	<br><font color=blue size=4>单分散性  </font>\n<br>monodispersity\n
单分散聚合物  	<br><font color=blue size=4>单分散聚合物  </font>\n<br>monodisperse polymer, uniform polymer\n
单组分纤维  	<br><font color=blue size=4>单组分纤维  </font>\n<br>homofiber\n
单丝  	<br><font color=blue size=4>单丝  </font>\n<br>monofilament, monofil\n
单股聚合物  	<br><font color=blue size=4>单股聚合物  </font>\n<br>single-strand polymer\n
单轴取向  	<br><font color=blue size=4>单轴取向  </font>\n<br>uniaxial orientation\n
单轴拉伸  	<br><font color=blue size=4>单轴拉伸  </font>\n<br>uniaxial drawing，uniaxial elongation\n
单体  	<br><font color=blue size=4>单体  </font>\n<br>monomer\n
单体单元  	<br><font color=blue size=4>单体单元  </font>\n<br>monomeric unit\n
单体浇铸  	<br><font color=blue size=4>单体浇铸  </font>\n<br>monomer casting\n
喷射纺丝  	<br><font color=blue size=4>喷射纺丝  </font>\n<br>jet spinning\n
喷纺成形  	<br><font color=blue size=4>喷纺成形  </font>\n<br>spray spinning\n
四中心聚合  	<br><font color=blue size=4>四中心聚合  </font>\n<br>four center polymerization\n
四单元组  	<br><font color=blue size=4>四单元组  </font>\n<br>tetrad\n
回弹  	<br><font color=blue size=4>回弹  </font>\n<br>resilience\n
回弹性  	<br><font color=blue size=4>回弹性  </font>\n<br>resilience\n
回缩性  	<br><font color=blue size=4>回缩性  </font>\n<br>nerviness\n
回转半径  	<br><font color=blue size=4>回转半径  </font>\n<br>radius of gyration\n
固化  	<br><font color=blue size=4>固化  </font>\n<br>curing, cure\n
固化剂  	<br><font color=blue size=4>固化剂  </font>\n<br>curing agent\n
固相挤出  	<br><font color=blue size=4>固相挤出  </font>\n<br>solid-phase extrusion\n
固相缩聚  	<br><font color=blue size=4>固相缩聚  </font>\n<br>solid phase polycondensation\n
固相聚合  	<br><font color=blue size=4>固相聚合  </font>\n<br>solid phase polymerization\n
均方旋转半径  	<br><font color=blue size=4>均方旋转半径  </font>\n<br>mean square radius of gyration\n
均方末端距  	<br><font color=blue size=4>均方末端距  </font>\n<br>mean square end to end distance\n
均方根末端距  	<br><font color=blue size=4>均方根末端距  </font>\n<br>root-mean-square end-to-end distance\n
均相缩聚  	<br><font color=blue size=4>均相缩聚  </font>\n<br>homopolycondensation\n
均相聚合  	<br><font color=blue size=4>均相聚合  </font>\n<br>homogeneous polymerization\n
均相茂金属催化剂  	<br><font color=blue size=4>均相茂金属催化剂  </font>\n<br>homogeneous metallocene catalyst\n
均聚反应  	<br><font color=blue size=4>均聚反应  </font>\n<br>homopolymerization\n
均聚物  	<br><font color=blue size=4>均聚物  </font>\n<br>homopolymer\n
垂挂  	<br><font color=blue size=4>垂挂  </font>\n<br>sag\n
埋置  	<br><font color=blue size=4>埋置  </font>\n<br>embedding, 又称“包埋”\n
基团转移聚合  	<br><font color=blue size=4>基团转移聚合  </font>\n<br>group transfer polymerization，GTP\n
基体  	<br><font color=blue size=4>基体  </font>\n<br>matrix\n
塑化  	<br><font color=blue size=4>塑化  </font>\n<br>plasticizing\n
塑性形变  	<br><font color=blue size=4>塑性形变  </font>\n<br>plastic deformation\n
塑性流动  	<br><font color=blue size=4>塑性流动  </font>\n<br>plastic flow\n
塑性体  	<br><font color=blue size=4>塑性体  </font>\n<br>plastomer\n
塑料  	<br><font color=blue size=4>塑料  </font>\n<br>plastic\n
塑料合金  	<br><font color=blue size=4>塑料合金  </font>\n<br>plastic alloy\n
塑炼  	<br><font color=blue size=4>塑炼  </font>\n<br>plastication\n
塑解剂  	<br><font color=blue size=4>塑解剂  </font>\n<br>peptizer\n
增塑作用  	<br><font color=blue size=4>增塑作用  </font>\n<br>plasticization\n
增塑剂  	<br><font color=blue size=4>增塑剂  </font>\n<br>plasticizer\n
增塑增容剂  	<br><font color=blue size=4>增塑增容剂  </font>\n<br>plasticizer extender\n
增塑溶胶  	<br><font color=blue size=4>增塑溶胶  </font>\n<br>plastisol\n
增容作用  	<br><font color=blue size=4>增容作用  </font>\n<br>compatiibilization\n
增容剂  	<br><font color=blue size=4>增容剂  </font>\n<br>compatibilizer\n
增强  	<br><font color=blue size=4>增强  </font>\n<br>reinforcing, 又称“补强”\n
增强剂  	<br><font color=blue size=4>增强剂  </font>\n<br>reinforcing agent\n
增强塑料  	<br><font color=blue size=4>增强塑料  </font>\n<br>reinforced plastic\n
增硬剂  	<br><font color=blue size=4>增硬剂  </font>\n<br>hardening agent\n
增稠剂  	<br><font color=blue size=4>增稠剂  </font>\n<br>thickening agent, thickener\n
增粘剂  	<br><font color=blue size=4>增粘剂  </font>\n<br>tackifier\n
增长链端  	<br><font color=blue size=4>增长链端  </font>\n<br>propagating chain end\n
增韧剂  	<br><font color=blue size=4>增韧剂  </font>\n<br>toughening agent\n
压延  	<br><font color=blue size=4>压延  </font>\n<br>calendering, 又称“轧光”\n
压延性  	<br><font color=blue size=4>压延性  </font>\n<br>calenderability\n
压敏型黏合剂  	<br><font color=blue size=4>压敏型黏合剂  </font>\n<br>pressure sensitive adhesive\n
压敏粘合  	<br><font color=blue size=4>压敏粘合  </font>\n<br>pressure sensitive adhesion\n
压片  	<br><font color=blue size=4>压片  </font>\n<br>preforming\n
压痕硬度  	<br><font color=blue size=4>压痕硬度  </font>\n<br>indentation hardness\n
压缩强度  	<br><font color=blue size=4>压缩强度  </font>\n<br>compressive strength\n
压缩成型  	<br><font color=blue size=4>压缩成型  </font>\n<br>compression forming\n
压缩永久变形  	<br><font color=blue size=4>压缩永久变形  </font>\n<br>compression set\n
压缩变形  	<br><font color=blue size=4>压缩变形  </font>\n<br>compressive deformation\n
压电高分子  	<br><font color=blue size=4>压电高分子  </font>\n<br>piezoelectric polymer\n
外增塑作用  	<br><font color=blue size=4>外增塑作用  </font>\n<br>external plasticization\n
外延晶体生长  	<br><font color=blue size=4>外延晶体生长  </font>\n<br>epitaxial growth\n
外延结晶  	<br><font color=blue size=4>外延结晶  </font>\n<br>epitaxial crystallization\n
外脱模剂  	<br><font color=blue size=4>外脱模剂  </font>\n<br>external releasing agent\n
多元聚合物  	<br><font color=blue size=4>多元聚合物  </font>\n<br>multipolymer\n
多分散性指数  	<br><font color=blue size=4>多分散性指数  </font>\n<br>polydispersity index，PID\n
多分散性聚合物  	<br><font color=blue size=4>多分散性聚合物  </font>\n<br>polydisperse polymer, non-uniform polymer\n
多孔膜  	<br><font color=blue size=4>多孔膜  </font>\n<br>porous membrane\n
多层共聚物  	<br><font color=blue size=4>多层共聚物  </font>\n<br>multilayer copolymer\n
多层吹塑  	<br><font color=blue size=4>多层吹塑  </font>\n<br>multi-layer blow molding\n
多层挤塑  	<br><font color=blue size=4>多层挤塑  </font>\n<br>multi-layer extrusion\n
多嵌段共聚物  	<br><font color=blue size=4>多嵌段共聚物  </font>\n<br>segmented copolymer\n
多晶形聚合物  	<br><font color=blue size=4>多晶形聚合物  </font>\n<br>polycrystalline polymer\n
多相聚合物  	<br><font color=blue size=4>多相聚合物  </font>\n<br>multiphase polymer\n
多组分共聚物  	<br><font color=blue size=4>多组分共聚物  </font>\n<br>multicomponent copolymer\n
多股聚合物  	<br><font color=blue size=4>多股聚合物  </font>\n<br>multi-strand polymer\n
多肽  	<br><font color=blue size=4>多肽  </font>\n<br>polypeptide\n
多轴拉伸  	<br><font color=blue size=4>多轴拉伸  </font>\n<br>multiaxial drawing\n
大分子单体  	<br><font color=blue size=4>大分子单体  </font>\n<br>macromer, macromonomer\n
大分子引发剂  	<br><font color=blue size=4>大分子引发剂  </font>\n<br>macroinitiator\n
大孔聚合物  	<br><font color=blue size=4>大孔聚合物  </font>\n<br>macroporous polymer\n
大环聚合物  	<br><font color=blue size=4>大环聚合物  </font>\n<br>macrocyclic polymer\n
大网络树脂  	<br><font color=blue size=4>大网络树脂  </font>\n<br>macroreticular resin\n
天然树脂  	<br><font color=blue size=4>天然树脂  </font>\n<br>natural resin\n
天然橡胶  	<br><font color=blue size=4>天然橡胶  </font>\n<br>natural rubber\n
天然纤维  	<br><font color=blue size=4>天然纤维  </font>\n<br>natural fiber\n
天然高分子  	<br><font color=blue size=4>天然高分子  </font>\n<br>natural polymer\n
官能单体  	<br><font color=blue size=4>官能单体  </font>\n<br>functional monomer\n
官能度  	<br><font color=blue size=4>官能度  </font>\n<br>functionality\n
定向聚合  	<br><font color=blue size=4>定向聚合  </font>\n<br>stereoregular polymerization, stereospecific polymerization\n
定型  	<br><font color=blue size=4>定型  </font>\n<br>sizing\n
室温硫化硅橡胶  	<br><font color=blue size=4>室温硫化硅橡胶  </font>\n<br>room temperature vulcanized silicone rubber\n
封端  	<br><font color=blue size=4>封端  </font>\n<br>end capping\n
射流注塑  	<br><font color=blue size=4>射流注塑  </font>\n<br>jet molding\n
对数正态分布  	<br><font color=blue size=4>对数正态分布  </font>\n<br>logarithmic normal distribution, 又称“对数正则分布”\n
对映［体］不对称聚合  	<br><font color=blue size=4>对映［体］不对称聚合  </font>\n<br>enantioasymmetric polymerization\n
对映［体］对称聚合  	<br><font color=blue size=4>对映［体］对称聚合  </font>\n<br>enantiosymmetric polymerization\n
导电聚合物  	<br><font color=blue size=4>导电聚合物  </font>\n<br>conducting polymer\n
小角激光光散射  	<br><font color=blue size=4>小角激光光散射  </font>\n<br>low angle laser light scattering\n
尼龙  	<br><font color=blue size=4>尼龙  </font>\n<br>polyamide fiber\n
尼龙3  	<br><font color=blue size=4>尼龙3  </font>\n<br>poly(β alanine)\n
尼龙6  	<br><font color=blue size=4>尼龙6  </font>\n<br>poly(ω amino caproic acid)\n
尼龙8  	<br><font color=blue size=4>尼龙8  </font>\n<br>poly(8 amino caprylic acid)\n
尾咬转移  	<br><font color=blue size=4>尾咬转移  </font>\n<br>backbitting transfer\n
尾-尾聚合物  	<br><font color=blue size=4>尾-尾聚合物  </font>\n<br>tail-to-tail polymer\n
尿素树脂  	<br><font color=blue size=4>尿素树脂  </font>\n<br>urea resin\n
屈服  	<br><font color=blue size=4>屈服  </font>\n<br>yielding\n
屈服强度  	<br><font color=blue size=4>屈服强度  </font>\n<br>yield strength\n
屈服应力  	<br><font color=blue size=4>屈服应力  </font>\n<br>yield stress\n
屈服应变  	<br><font color=blue size=4>屈服应变  </font>\n<br>yield strain\n
层压材料  	<br><font color=blue size=4>层压材料  </font>\n<br>laminate\n
嵌段  	<br><font color=blue size=4>嵌段  </font>\n<br>block\n
嵌段共聚合  	<br><font color=blue size=4>嵌段共聚合  </font>\n<br>block copolymerization\n
嵌段共聚物  	<br><font color=blue size=4>嵌段共聚物  </font>\n<br>block copolymer\n
嵌段聚合  	<br><font color=blue size=4>嵌段聚合  </font>\n<br>block polymerization\n
嵌段聚合物  	<br><font color=blue size=4>嵌段聚合物  </font>\n<br>block polymer\n
嵌段聚醚酯  	<br><font color=blue size=4>嵌段聚醚酯  </font>\n<br>block poly(ester ether)\n
工程塑料  	<br><font color=blue size=4>工程塑料  </font>\n<br>engineering plastic\n
布氏硬度  	<br><font color=blue size=4>布氏硬度  </font>\n<br>Brinell hardness\n
常温硫化  	<br><font color=blue size=4>常温硫化  </font>\n<br>auto-vulcanization\n
平均官能度  	<br><font color=blue size=4>平均官能度  </font>\n<br>average functionality\n
平均聚合度  	<br><font color=blue size=4>平均聚合度  </font>\n<br>average degree of polymerization\n
平移因子  	<br><font color=blue size=4>平移因子  </font>\n<br>shift factor\n
平行链晶体  	<br><font color=blue size=4>平行链晶体  </font>\n<br>parallel-chain crystal\n
平衡溶胀  	<br><font color=blue size=4>平衡溶胀  </font>\n<br>equilibrium swelling\n
平衡熔点  	<br><font color=blue size=4>平衡熔点  </font>\n<br>equilibrium melting point\n
平衡聚合  	<br><font color=blue size=4>平衡聚合  </font>\n<br>equilibrium polymerization\n
干喷湿法纺丝  	<br><font color=blue size=4>干喷湿法纺丝  </font>\n<br>dry jet wet spinning\n
干湿法纺丝  	<br><font color=blue size=4>干湿法纺丝  </font>\n<br>dry wet spinning\n
干纺  	<br><font color=blue size=4>干纺  </font>\n<br>dry spinning\n
几何等效  	<br><font color=blue size=4>几何等效  </font>\n<br>geometrical equivalence\n
序列共聚物  	<br><font color=blue size=4>序列共聚物  </font>\n<br>sequential copolymer\n
序列聚合  	<br><font color=blue size=4>序列聚合  </font>\n<br>sequential polymerization\n
序列长度分布  	<br><font color=blue size=4>序列长度分布  </font>\n<br>sequence length distribution\n
底漆  	<br><font color=blue size=4>底漆  </font>\n<br>primer\n
延性破裂  	<br><font color=blue size=4>延性破裂  </font>\n<br>ductile fracture\n
延迟作用  	<br><font color=blue size=4>延迟作用  </font>\n<br>retardation\n
延迟弹性  	<br><font color=blue size=4>延迟弹性  </font>\n<br>retarded elasticity\n
延迟形变  	<br><font color=blue size=4>延迟形变  </font>\n<br>retarded deformation\n
引发剂  	<br><font color=blue size=4>引发剂  </font>\n<br>initiator\n
引发剂效率  	<br><font color=blue size=4>引发剂效率  </font>\n<br>initiator efficiency\n
引发剂活性  	<br><font color=blue size=4>引发剂活性  </font>\n<br>activity of initiator\n
引发-转移剂  	<br><font color=blue size=4>引发-转移剂  </font>\n<br>initiator transfer agent, inifer\n
引发-转移-终止剂  	<br><font color=blue size=4>引发-转移-终止剂  </font>\n<br>initiator transfer agent terminator, iniferter\n
弗洛里-哈金斯理论  	<br><font color=blue size=4>弗洛里-哈金斯理论  </font>\n<br>Flory-Huggins theory\n
弛豫  	<br><font color=blue size=4>弛豫  </font>\n<br>relaxation, 又称“松弛”\n
弛豫时间  	<br><font color=blue size=4>弛豫时间  </font>\n<br>relaxation time\n
弛豫模量  	<br><font color=blue size=4>弛豫模量  </font>\n<br>relaxation modulus\n
弛豫谱  	<br><font color=blue size=4>弛豫谱  </font>\n<br>relaxation spectrum\n
弹性  	<br><font color=blue size=4>弹性  </font>\n<br>elasticity\n
弹性回复  	<br><font color=blue size=4>弹性回复  </font>\n<br>elastic recovery\n
弹性形变  	<br><font color=blue size=4>弹性形变  </font>\n<br>elastic deformation\n
弹性模量  	<br><font color=blue size=4>弹性模量  </font>\n<br>modulus of elasticity\n
弹性滞后  	<br><font color=blue size=4>弹性滞后  </font>\n<br>elastic hysteresis\n
弹性复原  	<br><font color=blue size=4>弹性复原  </font>\n<br>nerviness\n
弹性体  	<br><font color=blue size=4>弹性体  </font>\n<br>elastomer\n
弯曲强度  	<br><font color=blue size=4>弯曲强度  </font>\n<br>flexural strength, bending strength\n
弯曲应力  	<br><font color=blue size=4>弯曲应力  </font>\n<br>bending stress\n
弯曲应变  	<br><font color=blue size=4>弯曲应变  </font>\n<br>bending strain\n
弯曲模量  	<br><font color=blue size=4>弯曲模量  </font>\n<br>bending modulus\n
形状记忆高分子  	<br><font color=blue size=4>形状记忆高分子  </font>\n<br>shape-memory polymer\n
形变  	<br><font color=blue size=4>形变  </font>\n<br>deformation\n
后期结晶  	<br><font color=blue size=4>后期结晶  </font>\n<br>secondary crystallization\n
后发泡  	<br><font color=blue size=4>后发泡  </font>\n<br>post expansion\n
后硫化  	<br><font color=blue size=4>后硫化  </font>\n<br>post cure，post vulcanization\n
后聚合  	<br><font color=blue size=4>后聚合  </font>\n<br>post polymerization\n
后处理剂  	<br><font color=blue size=4>后处理剂  </font>\n<br>after-treating agent\n
后过渡金属催化剂  	<br><font color=blue size=4>后过渡金属催化剂  </font>\n<br>late transition metal catalyst\n
微乳液聚合  	<br><font color=blue size=4>微乳液聚合  </font>\n<br>micro emulsion polymerization\n
微凝胶  	<br><font color=blue size=4>微凝胶  </font>\n<br>microgel\n
微波硫化  	<br><font color=blue size=4>微波硫化  </font>\n<br>micro wave curing\n
微相  	<br><font color=blue size=4>微相  </font>\n<br>microphase\n
恒组分共聚合  	<br><font color=blue size=4>恒组分共聚合  </font>\n<br>azeotropic copolymerization\n
恒[组]分共聚物  	<br><font color=blue size=4>恒[组]分共聚物  </font>\n<br>azeotropic copolymer\n
惰性填料  	<br><font color=blue size=4>惰性填料  </font>\n<br>inert filler\n
感光聚合物  	<br><font color=blue size=4>感光聚合物  </font>\n<br>photopolymer\n
应力强度因子  	<br><font color=blue size=4>应力强度因子  </font>\n<br>stress intensity factor\n
应力-应变曲线  	<br><font color=blue size=4>应力-应变曲线  </font>\n<br>stress strain curve\n
应力致白  	<br><font color=blue size=4>应力致白  </font>\n<br>stress whitening\n
应力开裂  	<br><font color=blue size=4>应力开裂  </font>\n<br>stress cracking\n
应变张量  	<br><font color=blue size=4>应变张量  </font>\n<br>strain tensor\n
应变硬化  	<br><font color=blue size=4>应变硬化  </font>\n<br>strain hardening\n
应变能  	<br><font color=blue size=4>应变能  </font>\n<br>strain energy\n
应变软化  	<br><font color=blue size=4>应变软化  </font>\n<br>strain softening\n
悬浮聚合  	<br><font color=blue size=4>悬浮聚合  </font>\n<br>suspension polymerization\n
成核作用  	<br><font color=blue size=4>成核作用  </font>\n<br>nucleation\n
成纤  	<br><font color=blue size=4>成纤  </font>\n<br>fiber forming\n
手性高分子  	<br><font color=blue size=4>手性高分子  </font>\n<br>chiral polymer\n
扭辫分析  	<br><font color=blue size=4>扭辫分析  </font>\n<br>torsional braid analysis，TBA\n
抗刮性  	<br><font color=blue size=4>抗刮性  </font>\n<br>scrath resistance\n
抗微生物剂  	<br><font color=blue size=4>抗微生物剂  </font>\n<br>biocide\n
抗撕强度  	<br><font color=blue size=4>抗撕强度  </font>\n<br>tearing strength, 又称“抗扯强度”\n
抗氧剂  	<br><font color=blue size=4>抗氧剂  </font>\n<br>antioxidant\n
抗冲改性剂  	<br><font color=blue size=4>抗冲改性剂  </font>\n<br>impact modifier\n
抗疲劳剂  	<br><font color=blue size=4>抗疲劳剂  </font>\n<br>anti-fatigue agent\n
抗硫化返原剂  	<br><font color=blue size=4>抗硫化返原剂  </font>\n<br>anti-reversion agent\n
抗降解剂  	<br><font color=blue size=4>抗降解剂  </font>\n<br>antidegradant\n
抗静电剂  	<br><font color=blue size=4>抗静电剂  </font>\n<br>antistatic agent\n
抗静电添加剂  	<br><font color=blue size=4>抗静电添加剂  </font>\n<br>antistatic additive\n
抗龟裂剂  	<br><font color=blue size=4>抗龟裂剂  </font>\n<br>anticracking agent\n
折光指数增量  	<br><font color=blue size=4>折光指数增量  </font>\n<br>refractive index increment\n
折迭微区  	<br><font color=blue size=4>折迭微区  </font>\n<br>fold domain\n
折迭表面  	<br><font color=blue size=4>折迭表面  </font>\n<br>fold surface\n
折迭链  	<br><font color=blue size=4>折迭链  </font>\n<br>folded chain\n
折迭链晶体  	<br><font color=blue size=4>折迭链晶体  </font>\n<br>folded-chain crystal\n
折迭面  	<br><font color=blue size=4>折迭面  </font>\n<br>fold plane\n
拉伸吹塑成型  	<br><font color=blue size=4>拉伸吹塑成型  </font>\n<br>stretch blow molding\n
拉伸强度  	<br><font color=blue size=4>拉伸强度  </font>\n<br>tensile strength, 又称“断裂强度, breaking strength”\n
拉伸应力弛豫  	<br><font color=blue size=4>拉伸应力弛豫  </font>\n<br>tensile stress relaxation\n
拉伸应变  	<br><font color=blue size=4>拉伸应变  </font>\n<br>stretching strain\n
拉伸比  	<br><font color=blue size=4>拉伸比  </font>\n<br>draw ratio, extension ratio\n
拉伸热成型  	<br><font color=blue size=4>拉伸热成型  </font>\n<br>stretch thermoforming\n
拉伸黏度  	<br><font color=blue size=4>拉伸黏度  </font>\n<br>extensional viscosity\n
拉胀性  	<br><font color=blue size=4>拉胀性  </font>\n<br>auxiticity\n
拓扑化学聚合  	<br><font color=blue size=4>拓扑化学聚合  </font>\n<br>topochemical polymerization\n
拓扑缠结  	<br><font color=blue size=4>拓扑缠结  </font>\n<br>topological entanglement\n
持续自由基  	<br><font color=blue size=4>持续自由基  </font>\n<br>persistent radical\n
捏和  	<br><font color=blue size=4>捏和  </font>\n<br>kneading\n
排除体积  	<br><font color=blue size=4>排除体积  </font>\n<br>excluded volume\n
接枝共聚合  	<br><font color=blue size=4>接枝共聚合  </font>\n<br>graft copolymerization\n
接枝共聚物  	<br><font color=blue size=4>接枝共聚物  </font>\n<br>graft copolymer\n
接枝度  	<br><font color=blue size=4>接枝度  </font>\n<br>grafting degree\n
接枝效率  	<br><font color=blue size=4>接枝效率  </font>\n<br>efficiency of grafting\n
接枝聚合  	<br><font color=blue size=4>接枝聚合  </font>\n<br>graft polymerization\n
接枝聚合物  	<br><font color=blue size=4>接枝聚合物  </font>\n<br>graft polymer\n
接枝点  	<br><font color=blue size=4>接枝点  </font>\n<br>grafting site\n
接线板模型  	<br><font color=blue size=4>接线板模型  </font>\n<br>switchboard model\n
控制自由基聚合  	<br><font color=blue size=4>控制自由基聚合  </font>\n<br>controlled radical polymerization，CRP\n
推迟时间  	<br><font color=blue size=4>推迟时间  </font>\n<br>retardation time\n
推迟[时间]谱  	<br><font color=blue size=4>推迟[时间]谱  </font>\n<br>retardation [time] spectrum\n
插入聚合  	<br><font color=blue size=4>插入聚合  </font>\n<br>insertion polymerization\n
插层聚合  	<br><font color=blue size=4>插层聚合  </font>\n<br>intercalation polymerization\n
损耗模量  	<br><font color=blue size=4>损耗模量  </font>\n<br>loss modulus\n
摩擦系数  	<br><font color=blue size=4>摩擦系数  </font>\n<br>frictional coefficient\n
摩尔质量平均  	<br><font color=blue size=4>摩尔质量平均  </font>\n<br>molar mass average\n
摩尔质量排除极限  	<br><font color=blue size=4>摩尔质量排除极限  </font>\n<br>molar mass exclusion limit\n
挠性聚合物  	<br><font color=blue size=4>挠性聚合物  </font>\n<br>flexomer\n
挠曲  	<br><font color=blue size=4>挠曲  </font>\n<br>deflection\n
捻度  	<br><font color=blue size=4>捻度  </font>\n<br>twist\n
挤出  	<br><font color=blue size=4>挤出  </font>\n<br>extrusion, 又称“压出”\n
挤出吹塑  	<br><font color=blue size=4>挤出吹塑  </font>\n<br>extrusion blow molding\n
挤拉吹塑成型  	<br><font color=blue size=4>挤拉吹塑成型  </font>\n<br>extrusion draw blow molding\n
扩散控制终止  	<br><font color=blue size=4>扩散控制终止  </font>\n<br>diffusion controlled termination\n
扩链剂  	<br><font color=blue size=4>扩链剂  </font>\n<br>chain extender\n
扰动尺寸  	<br><font color=blue size=4>扰动尺寸  </font>\n<br>perturbed dimension\n
支化密度  	<br><font color=blue size=4>支化密度  </font>\n<br>branching density\n
支化度  	<br><font color=blue size=4>支化度  </font>\n<br>degree of branching\n
支化系数  	<br><font color=blue size=4>支化系数  </font>\n<br>branching index\n
支化聚合物  	<br><font color=blue size=4>支化聚合物  </font>\n<br>branched polymer\n
支链  	<br><font color=blue size=4>支链  </font>\n<br>branch chain\n
支链淀粉  	<br><font color=blue size=4>支链淀粉  </font>\n<br>amylopectin\n
收缩开裂  	<br><font color=blue size=4>收缩开裂  </font>\n<br>shrinkage crack\n
改性纤维  	<br><font color=blue size=4>改性纤维  </font>\n<br>differential fiber, 俗称“差别纤维”\n
散射的非对称性  	<br><font color=blue size=4>散射的非对称性  </font>\n<br>dissymmetry of scattering\n
数均分子量  	<br><font color=blue size=4>数均分子量  </font>\n<br>number-average molecular weight, number-average molar mass\n
数量分布函数  	<br><font color=blue size=4>数量分布函数  </font>\n<br>number distribution function\n
断裂伸长  	<br><font color=blue size=4>断裂伸长  </font>\n<br>elongation at break\n
断裂力学  	<br><font color=blue size=4>断裂力学  </font>\n<br>fracture mechanics\n
断裂韧性  	<br><font color=blue size=4>断裂韧性  </font>\n<br>fracture toughness\n
断链降解  	<br><font color=blue size=4>断链降解  </font>\n<br>chain scission degradation\n
旋转光闸法  	<br><font color=blue size=4>旋转光闸法  </font>\n<br>rotating sector method\n
旦  	<br><font color=blue size=4>旦  </font>\n<br>denier 纤度单位, 9000米纤维重1克为1旦\n
明胶  	<br><font color=blue size=4>明胶  </font>\n<br>gelatin\n
易位聚合  	<br><font color=blue size=4>易位聚合  </font>\n<br>metathesis polymerization\n
星形聚合物  	<br><font color=blue size=4>星形聚合物  </font>\n<br>star polymer\n
时-温迭加原理  	<br><font color=blue size=4>时-温迭加原理  </font>\n<br>time-temperature superposition principle\n
普适标定  	<br><font color=blue size=4>普适标定  </font>\n<br>universal calibration\n
晶体折迭周期  	<br><font color=blue size=4>晶体折迭周期  </font>\n<br>crystalline fold period\n
智能聚合物  	<br><font color=blue size=4>智能聚合物  </font>\n<br>intelligent polymer\n
暴聚  	<br><font color=blue size=4>暴聚  </font>\n<br>flash polymerization (俗称)\n
最低临界共溶温度  	<br><font color=blue size=4>最低临界共溶温度  </font>\n<br>lower critical solution temperature, LCST\n
最概然分布  	<br><font color=blue size=4>最概然分布  </font>\n<br>most probable distribution, 曾用名“最可几分布”\n
最高临界共溶温度  	<br><font color=blue size=4>最高临界共溶温度  </font>\n<br>upper critical solution temperature , UCST\n
有机-无机杂化材料  	<br><font color=blue size=4>有机-无机杂化材料  </font>\n<br>organic inorganic hybrid material\n
有机硅树脂  	<br><font color=blue size=4>有机硅树脂  </font>\n<br>silicone resin\n
有机高分子  	<br><font color=blue size=4>有机高分子  </font>\n<br>organic polymer\n
有规立构嵌段  	<br><font color=blue size=4>有规立构嵌段  </font>\n<br>isotactic block\n
有规立构聚合  	<br><font color=blue size=4>有规立构聚合  </font>\n<br>tactic polymerization\n
有规立构聚合物  	<br><font color=blue size=4>有规立构聚合物  </font>\n<br>stereoregular polymer, tactic polymer\n
有规聚合物  	<br><font color=blue size=4>有规聚合物  </font>\n<br>stereoregular polymer, tactic polymer\n
木素  	<br><font color=blue size=4>木素  </font>\n<br>lignin\n
末端距  	<br><font color=blue size=4>末端距  </font>\n<br>end-to-end distance\n
末端间矢量  	<br><font color=blue size=4>末端间矢量  </font>\n<br>end-to-end vector\n
本体模量  	<br><font color=blue size=4>本体模量  </font>\n<br>bulk modulus\n
本体聚合  	<br><font color=blue size=4>本体聚合  </font>\n<br>bulk polymerization, mass polymerization\n
本体黏度  	<br><font color=blue size=4>本体黏度  </font>\n<br>bulk viscosity\n
杜仲胶  	<br><font color=blue size=4>杜仲胶  </font>\n<br>Eucommea rubber\n
染料敏化光引发  	<br><font color=blue size=4>染料敏化光引发  </font>\n<br>dye sensitized phtoinitiation\n
柔性链  	<br><font color=blue size=4>柔性链  </font>\n<br>flexible chain\n
柔性链聚合物  	<br><font color=blue size=4>柔性链聚合物  </font>\n<br>flexible chain polymer\n
柱分级  	<br><font color=blue size=4>柱分级  </font>\n<br>column fractionation\n
核-壳共聚物  	<br><font color=blue size=4>核-壳共聚物  </font>\n<br>core shell copolymer\n
核-壳胶乳聚合物  	<br><font color=blue size=4>核-壳胶乳聚合物  </font>\n<br>core shell latex polymer\n
条带织构  	<br><font color=blue size=4>条带织构  </font>\n<br>banded texture\n
梯度共聚物  	<br><font color=blue size=4>梯度共聚物  </font>\n<br>gradient copolymer\n
梯形聚合物  	<br><font color=blue size=4>梯形聚合物  </font>\n<br>ladder polymer\n
梳形聚合物  	<br><font color=blue size=4>梳形聚合物  </font>\n<br>comb polymer\n
棒状链  	<br><font color=blue size=4>棒状链  </font>\n<br>rodlike chain\n
棒状高分子  	<br><font color=blue size=4>棒状高分子  </font>\n<br>rodlike polymer\n
杨氏模量  	<br><font color=blue size=4>杨氏模量  </font>\n<br>Young's modulus\n
极性单体  	<br><font color=blue size=4>极性单体  </font>\n<br>polar monomer\n
极性聚合物  	<br><font color=blue size=4>极性聚合物  </font>\n<br>polar polymer\n
极限拉伸强度  	<br><font color=blue size=4>极限拉伸强度  </font>\n<br>ultimate tensile strength\n
构型单元  	<br><font color=blue size=4>构型单元  </font>\n<br>configurational unit\n
构型无序  	<br><font color=blue size=4>构型无序  </font>\n<br>configurational disorder\n
构象无序  	<br><font color=blue size=4>构象无序  </font>\n<br>conformational disorder\n
构象重复单元  	<br><font color=blue size=4>构象重复单元  </font>\n<br>conformational repeating unit\n
模塑  	<br><font color=blue size=4>模塑  </font>\n<br>molding, 又称“模压”\n
模压成型  	<br><font color=blue size=4>模压成型  </font>\n<br>compression molding\n
模压硫化  	<br><font color=blue size=4>模压硫化  </font>\n<br>moulding curing\n
模板聚合  	<br><font color=blue size=4>模板聚合  </font>\n<br>matrix polymerization,template polymerization\n
树枝[状]晶体  	<br><font color=blue size=4>树枝[状]晶体  </font>\n<br>dendrite\n
树状高分子  	<br><font color=blue size=4>树状高分子  </font>\n<br>dendrimer, dendritic polymer, tree polymer\n
树脂  	<br><font color=blue size=4>树脂  </font>\n<br>resin\n
树脂传递成型  	<br><font color=blue size=4>树脂传递成型  </font>\n<br>resin transfer molding\n
树胶  	<br><font color=blue size=4>树胶  </font>\n<br>gum\n
桥基茂金属  	<br><font color=blue size=4>桥基茂金属  </font>\n<br>bridged metallocene\n
橡胶  	<br><font color=blue size=4>橡胶  </font>\n<br>rubber\n
橡胶态  	<br><font color=blue size=4>橡胶态  </font>\n<br>rubber state\n
橡胶改性塑料  	<br><font color=blue size=4>橡胶改性塑料  </font>\n<br>rubber modified plastics, rubberresin blends\n
橡胶胶乳  	<br><font color=blue size=4>橡胶胶乳  </font>\n<br>rubber latex\n
橡胶配合  	<br><font color=blue size=4>橡胶配合  </font>\n<br>rubber compounding\n
欠硫  	<br><font color=blue size=4>欠硫  </font>\n<br>under cure\n
次级弛豫  	<br><font color=blue size=4>次级弛豫  </font>\n<br>secondary relaxation\n
次级弛豫温度  	<br><font color=blue size=4>次级弛豫温度  </font>\n<br>secondary relaxation temperature\n
次级转变  	<br><font color=blue size=4>次级转变  </font>\n<br>secondary transition\n
正离子交换树脂  	<br><font color=blue size=4>正离子交换树脂  </font>\n<br>cation exchange resin\n
正离子交换膜  	<br><font color=blue size=4>正离子交换膜  </font>\n<br>cation exchange membrane\n
正离子催化剂  	<br><font color=blue size=4>正离子催化剂  </font>\n<br>cationic catalyst\n
正离子引发剂  	<br><font color=blue size=4>正离子引发剂  </font>\n<br>cationic initiator\n
正离子聚合  	<br><font color=blue size=4>正离子聚合  </font>\n<br>cationic polymerization\n
歧化终止  	<br><font color=blue size=4>歧化终止  </font>\n<br>disproportionation termination\n
死端聚合  	<br><font color=blue size=4>死端聚合  </font>\n<br>dead end polymerization (曾用名)\n
母胶  	<br><font color=blue size=4>母胶  </font>\n<br>masterbatch\n
比浓对数黏度  	<br><font color=blue size=4>比浓对数黏度  </font>\n<br>inherent viscosity, logarithmic viscosity number\n
比浓黏度  	<br><font color=blue size=4>比浓黏度  </font>\n<br>reduced viscosity\n
毛细管黏度计  	<br><font color=blue size=4>毛细管黏度计  </font>\n<br>capillary viscometer\n
氟树脂  	<br><font color=blue size=4>氟树脂  </font>\n<br>fluoroethylene resin\n
氟橡胶  	<br><font color=blue size=4>氟橡胶  </font>\n<br>fluororubber, fluoroelastomer\n
氟硅橡胶  	<br><font color=blue size=4>氟硅橡胶  </font>\n<br>fluorosilicone rubber\n
氟碳树脂  	<br><font color=blue size=4>氟碳树脂  </font>\n<br>fluorocarbon resin\n
氟醚橡胶  	<br><font color=blue size=4>氟醚橡胶  </font>\n<br>fluoroether rubber\n
气相聚合  	<br><font color=blue size=4>气相聚合  </font>\n<br>gaseous polymerization, gas phase polymerization\n
气辅注塑  	<br><font color=blue size=4>气辅注塑  </font>\n<br>gas aided injection molding\n
氧化偶联聚合  	<br><font color=blue size=4>氧化偶联聚合  </font>\n<br>oxidative coupling polymerization\n
氧化性聚合物  	<br><font color=blue size=4>氧化性聚合物  </font>\n<br>oxidative polymer\n
氧化聚合  	<br><font color=blue size=4>氧化聚合  </font>\n<br>oxidative polymerization\n
氧化还原引发剂  	<br><font color=blue size=4>氧化还原引发剂  </font>\n<br>redox initiator\n
氧化还原树脂  	<br><font color=blue size=4>氧化还原树脂  </font>\n<br>redox resin\n
氧化还原聚合  	<br><font color=blue size=4>氧化还原聚合  </font>\n<br>redox polymerization\n
氧杂环丁烷聚合物  	<br><font color=blue size=4>氧杂环丁烷聚合物  </font>\n<br>oxetane polymer\n
氨基树脂  	<br><font color=blue size=4>氨基树脂  </font>\n<br>amino resin\n
氨纶  	<br><font color=blue size=4>氨纶  </font>\n<br>polyurethane elastic fiber\n
氢化丁腈橡胶  	<br><font color=blue size=4>氢化丁腈橡胶  </font>\n<br>hydrogenated butadiene-acrylonitrile rubber\n
氢化橡胶  	<br><font color=blue size=4>氢化橡胶  </font>\n<br>hydrogenated rubber\n
氢转移聚合  	<br><font color=blue size=4>氢转移聚合  </font>\n<br>hydrogen transfer polymerization\n
氮氧[自由基]调控聚合  	<br><font color=blue size=4>氮氧[自由基]调控聚合  </font>\n<br>nitroxide mediated polymerization\n
氯丁橡胶  	<br><font color=blue size=4>氯丁橡胶  </font>\n<br>chloroprene rubber\n
氯化聚乙烯  	<br><font color=blue size=4>氯化聚乙烯  </font>\n<br>chlorinated polyethylene (CPE)\n
氯磺化聚乙烯  	<br><font color=blue size=4>氯磺化聚乙烯  </font>\n<br>chlorosulfonated polyethylene\n
氯纶  	<br><font color=blue size=4>氯纶  </font>\n<br>polyvinyl chloride fiber\n
氯醚橡胶  	<br><font color=blue size=4>氯醚橡胶  </font>\n<br>epichloro-hydrin rubber\n
水溶性高分子  	<br><font color=blue size=4>水溶性高分子  </font>\n<br>water soluble polymer\n
水解降解  	<br><font color=blue size=4>水解降解  </font>\n<br>hydrolytic degradation\n
永久变形  	<br><font color=blue size=4>永久变形  </font>\n<br>deformation set\n
沉淀分级  	<br><font color=blue size=4>沉淀分级  </font>\n<br>precipitation fractionation\n
沉淀聚合  	<br><font color=blue size=4>沉淀聚合  </font>\n<br>precipitation polymerization\n
沉降平衡  	<br><font color=blue size=4>沉降平衡  </font>\n<br>sedimentation equilibrium\n
沉降平衡法  	<br><font color=blue size=4>沉降平衡法  </font>\n<br>sedimentation equilibrium method\n
沉降系数  	<br><font color=blue size=4>沉降系数  </font>\n<br>sedimentation coefficient\n
沉降速度法  	<br><font color=blue size=4>沉降速度法  </font>\n<br>sedimentation velocity method\n
冲压成型  	<br><font color=blue size=4>冲压成型  </font>\n<br>impact molding\n
冲压模塑  	<br><font color=blue size=4>冲压模塑  </font>\n<br>impact moulding, shock moulding\n
冲击强度  	<br><font color=blue size=4>冲击强度  </font>\n<br>impact strength\n
油漆  	<br><font color=blue size=4>油漆  </font>\n<br>paint\n
泊松比  	<br><font color=blue size=4>泊松比  </font>\n<br>Poisson's ratio\n
法向应力  	<br><font color=blue size=4>法向应力  </font>\n<br>normal stress\n
泡沫塑料成型  	<br><font color=blue size=4>泡沫塑料成型  </font>\n<br>foam molding\n
注塑压缩成型  	<br><font color=blue size=4>注塑压缩成型  </font>\n<br>injection compression molding\n
注塑焊接  	<br><font color=blue size=4>注塑焊接  </font>\n<br>injection welding\n
注射成型  	<br><font color=blue size=4>注射成型  </font>\n<br>injection molding\n
洗脱分级  	<br><font color=blue size=4>洗脱分级  </font>\n<br>elution fractionation\n
洗脱剂  	<br><font color=blue size=4>洗脱剂  </font>\n<br>eluant\n
洗脱体积  	<br><font color=blue size=4>洗脱体积  </font>\n<br>elution volume\n
洛氏硬度  	<br><font color=blue size=4>洛氏硬度  </font>\n<br>Rockwell hardness\n
活化促进剂  	<br><font color=blue size=4>活化促进剂  </font>\n<br>activating accelerator\n
活化剂  	<br><font color=blue size=4>活化剂  </font>\n<br>activator\n
活化单体  	<br><font color=blue size=4>活化单体  </font>\n<br>activated monomer\n
活化接枝  	<br><font color=blue size=4>活化接枝  </font>\n<br>activation grafting\n
活化缩聚  	<br><font color=blue size=4>活化缩聚  </font>\n<br>activated polycondensation\n
活性中心  	<br><font color=blue size=4>活性中心  </font>\n<br>active center\n
活性正离子聚合  	<br><font color=blue size=4>活性正离子聚合  </font>\n<br>living cationic polymerization\n
活性碳纤维  	<br><font color=blue size=4>活性碳纤维  </font>\n<br>active carbon fiber\n
活性种  	<br><font color=blue size=4>活性种  </font>\n<br>reactive species\n
活性聚合  	<br><font color=blue size=4>活性聚合  </font>\n<br>living polymerization\n
活性自由基聚合  	<br><font color=blue size=4>活性自由基聚合  </font>\n<br>living radical polymerization\n
活性负离子聚合  	<br><font color=blue size=4>活性负离子聚合  </font>\n<br>living anionic polymerization\n
活性开环聚合  	<br><font color=blue size=4>活性开环聚合  </font>\n<br>living ring opening polymerization\n
活性高分子  	<br><font color=blue size=4>活性高分子  </font>\n<br>living polymer\n
流动双折射  	<br><font color=blue size=4>流动双折射  </font>\n<br>flow birefringence, streaming birefringence\n
流体力学等效球  	<br><font color=blue size=4>流体力学等效球  </font>\n<br>hydrodynamically equivalent sphere\n
流体力学体积  	<br><font color=blue size=4>流体力学体积  </font>\n<br>hydrodynamic volume\n
浸渍  	<br><font color=blue size=4>浸渍  </font>\n<br>impregnation\n
浸渍树脂  	<br><font color=blue size=4>浸渍树脂  </font>\n<br>solvent impregnated resin\n
消泡剂  	<br><font color=blue size=4>消泡剂  </font>\n<br>antifoaming agent\n
消除聚合  	<br><font color=blue size=4>消除聚合  </font>\n<br>elimination polymerization\n
液晶态  	<br><font color=blue size=4>液晶态  </font>\n<br>liquid crystal state\n
液晶纺丝  	<br><font color=blue size=4>液晶纺丝  </font>\n<br>liquid crystal spinning\n
液晶高分子  	<br><font color=blue size=4>液晶高分子  </font>\n<br>liquid crystal polymer\n
液体橡胶  	<br><font color=blue size=4>液体橡胶  </font>\n<br>liquid rubber\n
淋洗分级  	<br><font color=blue size=4>淋洗分级  </font>\n<br>elution fractionation\n
淤浆聚合  	<br><font color=blue size=4>淤浆聚合  </font>\n<br>slurry polymerization\n
混容性  	<br><font color=blue size=4>混容性  </font>\n<br>miscibility\n
混炼  	<br><font color=blue size=4>混炼  </font>\n<br>milling, mixing\n
混杂复合材料  	<br><font color=blue size=4>混杂复合材料  </font>\n<br>hybrid composite\n
添加剂  	<br><font color=blue size=4>添加剂  </font>\n<br>additive\n
减阻剂  	<br><font color=blue size=4>减阻剂  </font>\n<br>drag reducer\n
溶剂梯度洗脱色谱法  	<br><font color=blue size=4>溶剂梯度洗脱色谱法  </font>\n<br>solvent gradient [elution] chromatography\n
溶剂热力学性质  	<br><font color=blue size=4>溶剂热力学性质  </font>\n<br>thermodynamic quality of solvent\n
溶度参数  	<br><font color=blue size=4>溶度参数  </font>\n<br>solubility parameter\n
溶液纺丝  	<br><font color=blue size=4>溶液纺丝  </font>\n<br>solution spinning\n
溶液聚合  	<br><font color=blue size=4>溶液聚合  </font>\n<br>solution polymerization\n
溶聚丁苯橡胶  	<br><font color=blue size=4>溶聚丁苯橡胶  </font>\n<br>solution polymerized butadiene styrene rubber(SSBR)\n
溶胀  	<br><font color=blue size=4>溶胀  </font>\n<br>swelling\n
溶胀因子  	<br><font color=blue size=4>溶胀因子  </font>\n<br>expansion factor\n
溶胀度  	<br><font color=blue size=4>溶胀度  </font>\n<br>degree of swelling\n
溶胶-凝胶转化  	<br><font color=blue size=4>溶胶-凝胶转化  </font>\n<br>sol-gel transformation\n
溶致性液晶  	<br><font color=blue size=4>溶致性液晶  </font>\n<br>lyotopic liquid crystal\n
溶致液晶高分子  	<br><font color=blue size=4>溶致液晶高分子  </font>\n<br>lyotropic liquid crystalline polymer\n
涤纶  	<br><font color=blue size=4>涤纶  </font>\n<br>polyester fiber\n
滚塑  	<br><font color=blue size=4>滚塑  </font>\n<br>rotational moulding\n
潜固化剂  	<br><font color=blue size=4>潜固化剂  </font>\n<br>latent curing agent\n
润滑剂  	<br><font color=blue size=4>润滑剂  </font>\n<br>lubricant\n
浇铸聚合  	<br><font color=blue size=4>浇铸聚合  </font>\n<br>cast polymerization\n
淀粉  	<br><font color=blue size=4>淀粉  </font>\n<br>amylum，starch\n
激光光纤  	<br><font color=blue size=4>激光光纤  </font>\n<br>laser fiber\n
激光共聚焦荧光显微镜  	<br><font color=blue size=4>激光共聚焦荧光显微镜  </font>\n<br>laser confocal fluorescence microscopy\n
激基缔合物荧光  	<br><font color=blue size=4>激基缔合物荧光  </font>\n<br>excimer fluorescence\n
激基复合物荧光  	<br><font color=blue size=4>激基复合物荧光  </font>\n<br>exciplex fluorescence\n
浓度猝灭  	<br><font color=blue size=4>浓度猝灭  </font>\n<br>concentration quenching\n
湿润剂  	<br><font color=blue size=4>湿润剂  </font>\n<br>wetting agent\n
湿纺  	<br><font color=blue size=4>湿纺  </font>\n<br>wet spinning\n
乌氏黏度计  	<br><font color=blue size=4>乌氏黏度计  </font>\n<br>[Ubbelohde] dilution viscometer\n
烯丙基树脂  	<br><font color=blue size=4>烯丙基树脂  </font>\n<br>allyl resin\n
烯丙基聚合  	<br><font color=blue size=4>烯丙基聚合  </font>\n<br>allylic polymerization\n
烯烃共聚物  	<br><font color=blue size=4>烯烃共聚物  </font>\n<br>olefine copolymer (OCP)\n
烯醇钠引发剂  	<br><font color=blue size=4>烯醇钠引发剂  </font>\n<br>alfin initiator\n
烯类聚合  	<br><font color=blue size=4>烯类聚合  </font>\n<br>vinyl polymerization\n
烯类聚合物  	<br><font color=blue size=4>烯类聚合物  </font>\n<br>vinyl polymer\n
烃类树脂  	<br><font color=blue size=4>烃类树脂  </font>\n<br>hydrocarbon resin\n
烷基锂引发剂  	<br><font color=blue size=4>烷基锂引发剂  </font>\n<br>alkyllithium initiator\n
无乳化剂乳液聚合  	<br><font color=blue size=4>无乳化剂乳液聚合  </font>\n<br>emulsifier free emulsion polymerization\n
无催化聚合  	<br><font color=blue size=4>无催化聚合  </font>\n<br>uncatalyzed polymerization\n
无压成型  	<br><font color=blue size=4>无压成型  </font>\n<br>zero ressure molding\n
无压硫化  	<br><font color=blue size=4>无压硫化  </font>\n<br>non-pressure cure\n
无定形相  	<br><font color=blue size=4>无定形相  </font>\n<br>amorphous phase (曾用名)\n
无扰尺寸  	<br><font color=blue size=4>无扰尺寸  </font>\n<br>unperturbed dimension\n
无扰末端距  	<br><font color=blue size=4>无扰末端距  </font>\n<br>unperturbed end-to-end distance\n
无模硫化  	<br><font color=blue size=4>无模硫化  </font>\n<br>open vulcanization\n
无机-有机高分子  	<br><font color=blue size=4>无机-有机高分子  </font>\n<br>inorganic organic polymer\n
无机高分子  	<br><font color=blue size=4>无机高分子  </font>\n<br>inorganic polymer\n
无活性端聚合  	<br><font color=blue size=4>无活性端聚合  </font>\n<br>dead end polymerization\n
无流道冷料注塑  	<br><font color=blue size=4>无流道冷料注塑  </font>\n<br>runnerless injection molding\n
无纺布  	<br><font color=blue size=4>无纺布  </font>\n<br>non-woven fabrics\n
无规交联  	<br><font color=blue size=4>无规交联  </font>\n<br>random crosslinking\n
无规共聚合  	<br><font color=blue size=4>无规共聚合  </font>\n<br>random copolymerization\n
无规共聚物  	<br><font color=blue size=4>无规共聚物  </font>\n<br>random copolymer\n
无规卷曲聚合物  	<br><font color=blue size=4>无规卷曲聚合物  </font>\n<br>random coiling polymer\n
无规度  	<br><font color=blue size=4>无规度  </font>\n<br>atacticity\n
无规立构嵌段  	<br><font color=blue size=4>无规立构嵌段  </font>\n<br>atactic block\n
无规立构度  	<br><font color=blue size=4>无规立构度  </font>\n<br>atacticity\n
无规立构聚合物  	<br><font color=blue size=4>无规立构聚合物  </font>\n<br>atactic polymer\n
无规线团  	<br><font color=blue size=4>无规线团  </font>\n<br>random coil\n
无规线团模型  	<br><font color=blue size=4>无规线团模型  </font>\n<br>random coil model\n
无规聚合物  	<br><font color=blue size=4>无规聚合物  </font>\n<br>random polymer\n
无规行走模型  	<br><font color=blue size=4>无规行走模型  </font>\n<br>random walk model\n
无规降解  	<br><font color=blue size=4>无规降解  </font>\n<br>random degradation\n
焦烧  	<br><font color=blue size=4>焦烧  </font>\n<br>scorching\n
荧光增白剂  	<br><font color=blue size=4>荧光增白剂  </font>\n<br>optical bleaching agent\n
熔纺  	<br><font color=blue size=4>熔纺  </font>\n<br>melt spinning\n
熔融缩聚  	<br><font color=blue size=4>熔融缩聚  </font>\n<br>melt phase polycondensation\n
熔铸  	<br><font color=blue size=4>熔铸  </font>\n<br>fusion casting\n
熔体流动指数  	<br><font color=blue size=4>熔体流动指数  </font>\n<br>melt [flow] index\n
熟成  	<br><font color=blue size=4>熟成  </font>\n<br>ripening\n
热分级  	<br><font color=blue size=4>热分级  </font>\n<br>thermal fractionation\n
热力学等效球  	<br><font color=blue size=4>热力学等效球  </font>\n<br>thermodynamically equivalent sphere\n
热固性树脂  	<br><font color=blue size=4>热固性树脂  </font>\n<br>thermosetting resin\n
热塑[性]弹性体  	<br><font color=blue size=4>热塑[性]弹性体  </font>\n<br>thermoplastic elastomer\n
热塑性树脂  	<br><font color=blue size=4>热塑性树脂  </font>\n<br>thermoplastic resin\n
热引发  	<br><font color=blue size=4>热引发  </font>\n<br>thermal initiation\n
热引发转移终止剂  	<br><font color=blue size=4>热引发转移终止剂  </font>\n<br>thermoiniferter\n
热成型  	<br><font color=blue size=4>热成型  </font>\n<br>thermal forming\n
热收缩  	<br><font color=blue size=4>热收缩  </font>\n<br>thermoshrinking\n
热敏性树脂  	<br><font color=blue size=4>热敏性树脂  </font>\n<br>thermally sensitive resin\n
热敏发光聚合物  	<br><font color=blue size=4>热敏发光聚合物  </font>\n<br>thermosensitive luminescence polymer\n
热历史  	<br><font color=blue size=4>热历史  </font>\n<br>thermal history\n
热-机械曲线  	<br><font color=blue size=4>热-机械曲线  </font>\n<br>thermo-mechanical curve\n
热氧化降解  	<br><font color=blue size=4>热氧化降解  </font>\n<br>thermal oxidative degradation\n
热氧老化  	<br><font color=blue size=4>热氧老化  </font>\n<br>thermo-oxidative ageing\n
热熔胶  	<br><font color=blue size=4>热熔胶  </font>\n<br>melt adhesive\n
热畸变温度  	<br><font color=blue size=4>热畸变温度  </font>\n<br>heat distortion temperature\n
热硫化  	<br><font color=blue size=4>热硫化  </font>\n<br>heat curing\n
热稳定剂  	<br><font color=blue size=4>热稳定剂  </font>\n<br>heat stabilizer\n
热老化  	<br><font color=blue size=4>热老化  </font>\n<br>thermal ageing\n
热聚合  	<br><font color=blue size=4>热聚合  </font>\n<br>thermal polymerization\n
热致性介晶  	<br><font color=blue size=4>热致性介晶  </font>\n<br>thermotropic mesomorphism\n
热致性液晶  	<br><font color=blue size=4>热致性液晶  </font>\n<br>thermotropic liquid crystal\n
热致液晶高分子  	<br><font color=blue size=4>热致液晶高分子  </font>\n<br>thermotropic liquid crystalline polymer\n
热解聚合物  	<br><font color=blue size=4>热解聚合物  </font>\n<br>pyrolytic polymer\n
热降解  	<br><font color=blue size=4>热降解  </font>\n<br>thermal degradation\n
热电性高分子  	<br><font color=blue size=4>热电性高分子  </font>\n<br>pyroelectric polymer\n
烧蚀剂  	<br><font color=blue size=4>烧蚀剂  </font>\n<br>ablator\n
烧蚀聚合物  	<br><font color=blue size=4>烧蚀聚合物  </font>\n<br>ablative polymer\n
片晶  	<br><font color=blue size=4>片晶  </font>\n<br>lamella, lamellar crystal\n
牛顿剪切黏度  	<br><font color=blue size=4>牛顿剪切黏度  </font>\n<br>Newtonian shear viscosity\n
牛顿流体  	<br><font color=blue size=4>牛顿流体  </font>\n<br>Newtonian fluid\n
物理交联  	<br><font color=blue size=4>物理交联  </font>\n<br>physical crosslinking\n
物理发泡  	<br><font color=blue size=4>物理发泡  </font>\n<br>physical foam\n
物理发泡剂  	<br><font color=blue size=4>物理发泡剂  </font>\n<br>physical foaming agent\n
物理缠结  	<br><font color=blue size=4>物理缠结  </font>\n<br>physical entanglement\n
物理老化  	<br><font color=blue size=4>物理老化  </font>\n<br>physical ageing\n
特  	<br><font color=blue size=4>特  </font>\n<br>tex 纤度单位, 1000米纤维重1克为1特\n
特性黏数  	<br><font color=blue size=4>特性黏数  </font>\n<br>intrinsic viscosity, limiting viscosity number\n
特殊性能高分子  	<br><font color=blue size=4>特殊性能高分子  </font>\n<br>speciality polymer\n
特种高分子  	<br><font color=blue size=4>特种高分子  </font>\n<br>speciality polymer\n
玻璃化转变  	<br><font color=blue size=4>玻璃化转变  </font>\n<br>glass transition\n
玻璃化转变温度  	<br><font color=blue size=4>玻璃化转变温度  </font>\n<br>glass-transition temperature\n
玻璃态  	<br><font color=blue size=4>玻璃态  </font>\n<br>glassy state\n
玻耳兹曼迭加原理  	<br><font color=blue size=4>玻耳兹曼迭加原理  </font>\n<br>Boltzmann superposition principle\n
珠-棒模型  	<br><font color=blue size=4>珠-棒模型  </font>\n<br>bead-rod model\n
珠状聚合  	<br><font color=blue size=4>珠状聚合  </font>\n<br>bead polymerization, pearl polymerization\n
球晶  	<br><font color=blue size=4>球晶  </font>\n<br>spherulite\n
球状链晶体  	<br><font color=blue size=4>球状链晶体  </font>\n<br>globular-chain crystal\n
球-簧链模型  	<br><font color=blue size=4>球-簧链模型  </font>\n<br>ball-spring [chain] model\n
理想共聚合  	<br><font color=blue size=4>理想共聚合  </font>\n<br>ideal copolymerization\n
瑞利比  	<br><font color=blue size=4>瑞利比  </font>\n<br>Rayleigh ratio\n
环加成聚合  	<br><font color=blue size=4>环加成聚合  </font>\n<br>cycloaddition polymerization\n
环化聚合  	<br><font color=blue size=4>环化聚合  </font>\n<br>cyclopolymerization\n
环带球晶  	<br><font color=blue size=4>环带球晶  </font>\n<br>ringed spherulite\n
环氧树脂  	<br><font color=blue size=4>环氧树脂  </font>\n<br>epoxy resin\n
环烯聚合  	<br><font color=blue size=4>环烯聚合  </font>\n<br>cycloalkene polymerization\n
环状单体  	<br><font color=blue size=4>环状单体  </font>\n<br>cyclic monomer\n
环硅氧烷聚合  	<br><font color=blue size=4>环硅氧烷聚合  </font>\n<br>cyclosiloxane polymerization\n
琼脂  	<br><font color=blue size=4>琼脂  </font>\n<br>agar-agar\n
生橡胶  	<br><font color=blue size=4>生橡胶  </font>\n<br>raw rubber，crude rubber\n
生物可蚀性高分子  	<br><font color=blue size=4>生物可蚀性高分子  </font>\n<br>bioerodable polymer\n
生物弹性体  	<br><font color=blue size=4>生物弹性体  </font>\n<br>bioelastomer\n
生物活性高分子  	<br><font color=blue size=4>生物活性高分子  </font>\n<br>bioactive polymer\n
生物兼容性  	<br><font color=blue size=4>生物兼容性  </font>\n<br>biocompatibility\n
生物医用高分子  	<br><font color=blue size=4>生物医用高分子  </font>\n<br>biomedical polymer\n
生物降解  	<br><font color=blue size=4>生物降解  </font>\n<br>biodegradation\n
生物降解高分子  	<br><font color=blue size=4>生物降解高分子  </font>\n<br>biodegradable polymer\n
生物高分子  	<br><font color=blue size=4>生物高分子  </font>\n<br>biopolymer\n
甲基乙烯基硅橡胶  	<br><font color=blue size=4>甲基乙烯基硅橡胶  </font>\n<br>methylvinyl silicone rubber\n
甲基纤维素  	<br><font color=blue size=4>甲基纤维素  </font>\n<br>methyl cellulose\n
甲基铝氧烷  	<br><font color=blue size=4>甲基铝氧烷  </font>\n<br>methylaluminoxane, MAO\n
甲壳质  	<br><font color=blue size=4>甲壳质  </font>\n<br>chitin\n
甲阶酚醛树脂  	<br><font color=blue size=4>甲阶酚醛树脂  </font>\n<br>resol, 又叫“可溶酚醛树脂”\n
界面相  	<br><font color=blue size=4>界面相  </font>\n<br>boundary phase\n
界面缩聚  	<br><font color=blue size=4>界面缩聚  </font>\n<br>interfacial polycondensation\n
界面聚合  	<br><font color=blue size=4>界面聚合  </font>\n<br>interfacial polymerization\n
异戊橡胶  	<br><font color=blue size=4>异戊橡胶  </font>\n<br>isoprene rubber\n
异构化聚合  	<br><font color=blue size=4>异构化聚合  </font>\n<br>isomerization polymerization\n
异规聚合物  	<br><font color=blue size=4>异规聚合物  </font>\n<br>heterotactic polymer\n
异质同晶聚合物  	<br><font color=blue size=4>异质同晶聚合物  </font>\n<br>polyallomer\n
异质复合纤维  	<br><font color=blue size=4>异质复合纤维  </font>\n<br>heterofiber\n
迭模压塑  	<br><font color=blue size=4>迭模压塑  </font>\n<br>stack moulding\n
疏水聚合物  	<br><font color=blue size=4>疏水聚合物  </font>\n<br>hydrophobic polymer\n
疲劳强度  	<br><font color=blue size=4>疲劳强度  </font>\n<br>fatigue strength, fatigue resistance\n
发泡  	<br><font color=blue size=4>发泡  </font>\n<br>expanding foam\n
发泡剂  	<br><font color=blue size=4>发泡剂  </font>\n<br>foaming agent\n
白蛋白  	<br><font color=blue size=4>白蛋白  </font>\n<br>albumin\n
皮层效应  	<br><font color=blue size=4>皮层效应  </font>\n<br>skin effect\n
皮心效应  	<br><font color=blue size=4>皮心效应  </font>\n<br>skin and core effect\n
皮芯纤维  	<br><font color=blue size=4>皮芯纤维  </font>\n<br>sheath core fiber\n
盘状相  	<br><font color=blue size=4>盘状相  </font>\n<br>discotic phase\n
直链淀粉  	<br><font color=blue size=4>直链淀粉  </font>\n<br>amylose\n
直链高分子  	<br><font color=blue size=4>直链高分子  </font>\n<br>straight chain polymer\n
相分离  	<br><font color=blue size=4>相分离  </font>\n<br>phase separation\n
兼容性  	<br><font color=blue size=4>兼容性  </font>\n<br>compatibility\n
相对黏度  	<br><font color=blue size=4>相对黏度  </font>\n<br>relative viscosity\n
相对黏度增量  	<br><font color=blue size=4>相对黏度增量  </font>\n<br>relative viscosity increment\n
相溶性  	<br><font color=blue size=4>相溶性  </font>\n<br>intermiscibility\n
相转化聚合  	<br><font color=blue size=4>相转化聚合  </font>\n<br>phase inversion polymerization\n
相邻再入模型  	<br><font color=blue size=4>相邻再入模型  </font>\n<br>adjacent re-entry model\n
相关长度  	<br><font color=blue size=4>相关长度  </font>\n<br>persistence length\n
真空成型  	<br><font color=blue size=4>真空成型  </font>\n<br>vacuum forming, 又称“吸塑”\n
真空烧结  	<br><font color=blue size=4>真空烧结  </font>\n<br>vacuum sintering\n
真空袋成型  	<br><font color=blue size=4>真空袋成型  </font>\n<br>vacuum bag molding\n
短支链  	<br><font color=blue size=4>短支链  </font>\n<br>short-chain branch\n
石油树脂  	<br><font color=blue size=4>石油树脂  </font>\n<br>petroleum resin\n
硅橡胶  	<br><font color=blue size=4>硅橡胶  </font>\n<br>silicon rubber\n
硅烷偶联剂  	<br><font color=blue size=4>硅烷偶联剂  </font>\n<br>silane coupling agent\n
硅酸盐聚合物  	<br><font color=blue size=4>硅酸盐聚合物  </font>\n<br>silicate polymer, polysilicate\n
破乳剂  	<br><font color=blue size=4>破乳剂  </font>\n<br>demulsifier\n
硝化纤维素  	<br><font color=blue size=4>硝化纤维素  </font>\n<br>cellulose nitrate\n
硝酸纤维素  	<br><font color=blue size=4>硝酸纤维素  </font>\n<br>cellulose nitrate\n
硫化  	<br><font color=blue size=4>硫化  </font>\n<br>vulcanization\n
硫化促进剂  	<br><font color=blue size=4>硫化促进剂  </font>\n<br>vulcanization accelerator\n
硫化剂  	<br><font color=blue size=4>硫化剂  </font>\n<br>vulcanizing agent\n
硫化橡胶  	<br><font color=blue size=4>硫化橡胶  </font>\n<br>vulcanized rubber, vulcanizate\n
硫化活化剂  	<br><font color=blue size=4>硫化活化剂  </font>\n<br>vulcanization activator\n
硫［黄］硫化  	<br><font color=blue size=4>硫［黄］硫化  </font>\n<br>sulfur vulcanization\n
硬质胶  	<br><font color=blue size=4>硬质胶  </font>\n<br>ebonite\n
碳化硼纤维  	<br><font color=blue size=4>碳化硼纤维  </font>\n<br>boron carbide fiber\n
碳正离子聚合  	<br><font color=blue size=4>碳正离子聚合  </font>\n<br>carbenium ion polymerization,carbocationic polymerization\n
碳环梯形聚合物  	<br><font color=blue size=4>碳环梯形聚合物  </font>\n<br>carbocyclic ladder polymer\n
碳纳米管  	<br><font color=blue size=4>碳纳米管  </font>\n<br>carbon nano-tube\n
碳纤维  	<br><font color=blue size=4>碳纤维  </font>\n<br>carbon fiber\n
碳负离子聚合  	<br><font color=blue size=4>碳负离子聚合  </font>\n<br>carbanionic polymerization\n
碳链聚合物  	<br><font color=blue size=4>碳链聚合物  </font>\n<br>carbon chain polymer\n
砜料  	<br><font color=blue size=4>砜料  </font>\n<br>coating\n
磁性聚合物  	<br><font color=blue size=4>磁性聚合物  </font>\n<br>magnetic polymer\n
种子聚合  	<br><font color=blue size=4>种子聚合  </font>\n<br>seeding polymerization\n
稳定自由基聚合  	<br><font color=blue size=4>稳定自由基聚合  </font>\n<br>stable free radical polymerization，FRP\n
立构嵌段  	<br><font color=blue size=4>立构嵌段  </font>\n<br>stereoblock\n
立构规整度  	<br><font color=blue size=4>立构规整度  </font>\n<br>tacticity\n
立构规整聚合  	<br><font color=blue size=4>立构规整聚合  </font>\n<br>stereoregular polymerization, stereospecific polymerization\n
立构重复单元  	<br><font color=blue size=4>立构重复单元  </font>\n<br>stereorepeating unit\n
端基  	<br><font color=blue size=4>端基  </font>\n<br>terminal group\n
端基分析  	<br><font color=blue size=4>端基分析  </font>\n<br>analysis of end group\n
竞聚率  	<br><font color=blue size=4>竞聚率  </font>\n<br>reactivity ratio\n
等同周期  	<br><font color=blue size=4>等同周期  </font>\n<br>identity period\n
等效链  	<br><font color=blue size=4>等效链  </font>\n<br>equivalent chain\n
等规度  	<br><font color=blue size=4>等规度  </font>\n<br>isotacticity\n
等规聚丙烯  	<br><font color=blue size=4>等规聚丙烯  </font>\n<br>isotactic polypropylene(iPP)\n
等规聚合物  	<br><font color=blue size=4>等规聚合物  </font>\n<br>isotactic polymer\n
等离子体加工  	<br><font color=blue size=4>等离子体加工  </font>\n<br>plasma processing\n
等离子体聚合  	<br><font color=blue size=4>等离子体聚合  </font>\n<br>plasma polymerization\n
米花状聚合物  	<br><font color=blue size=4>米花状聚合物  </font>\n<br>popcorn polymer\n
粉末橡胶  	<br><font color=blue size=4>粉末橡胶  </font>\n<br>powdered rubber\n
粒子散射函数  	<br><font color=blue size=4>粒子散射函数  </font>\n<br>particle scattering function\n
粒子散射因子  	<br><font color=blue size=4>粒子散射因子  </font>\n<br>particle scattering factor\n
粘合  	<br><font color=blue size=4>粘合  </font>\n<br>adhesion\n
粘合剂  	<br><font color=blue size=4>粘合剂  </font>\n<br>adhesive\n
粘度改进剂  	<br><font color=blue size=4>粘度改进剂  </font>\n<br>viscosity modifier\n
粘胶纤维  	<br><font color=blue size=4>粘胶纤维  </font>\n<br>viscose fiber\n
精密聚合  	<br><font color=blue size=4>精密聚合  </font>\n<br>precision polymerization\n
精细高分子  	<br><font color=blue size=4>精细高分子  </font>\n<br>fine polymer\n
糊塑  	<br><font color=blue size=4>糊塑  </font>\n<br>paste molding\n
糊精  	<br><font color=blue size=4>糊精  </font>\n<br>dextrin\n
糠醛树脂  	<br><font color=blue size=4>糠醛树脂  </font>\n<br>furfural resin\n
糠醛苯酚树脂  	<br><font color=blue size=4>糠醛苯酚树脂  </font>\n<br>furfural phenol resin\n
纳米纤维  	<br><font color=blue size=4>纳米纤维  </font>\n<br>nano-fiber\n
纳米复合材料  	<br><font color=blue size=4>纳米复合材料  </font>\n<br>nanocomposite\n
纱  	<br><font color=blue size=4>纱  </font>\n<br>yarn\n
素炼  	<br><font color=blue size=4>素炼  </font>\n<br>mastication\n
纺丝  	<br><font color=blue size=4>纺丝  </font>\n<br>spinning\n
纺织品整理剂  	<br><font color=blue size=4>纺织品整理剂  </font>\n<br>textile finishing agent\n
紫外光吸收剂  	<br><font color=blue size=4>紫外光吸收剂  </font>\n<br>ultraviolet absorber\n
紫外线稳定剂  	<br><font color=blue size=4>紫外线稳定剂  </font>\n<br>ultraviolet stabilizer\n
紫胶  	<br><font color=blue size=4>紫胶  </font>\n<br>shellac\n
细菌降解  	<br><font color=blue size=4>细菌降解  </font>\n<br>bacterial degradation\n
终止剂  	<br><font color=blue size=4>终止剂  </font>\n<br>terminator\n
组合纤维  	<br><font color=blue size=4>组合纤维  </font>\n<br>conjugate fiber\n
组成非均一性  	<br><font color=blue size=4>组成非均一性  </font>\n<br>constitutional heterogenity, compositional heterogenity\n
组织兼容性  	<br><font color=blue size=4>组织兼容性  </font>\n<br>tissue compatibility\n
结晶度  	<br><font color=blue size=4>结晶度  </font>\n<br>degree of crystallinity, crystallinity\n
结晶聚合物  	<br><font color=blue size=4>结晶聚合物  </font>\n<br>crystalline polymer\n
结构单元  	<br><font color=blue size=4>结构单元  </font>\n<br>constitutional unit\n
结构控制剂  	<br><font color=blue size=4>结构控制剂  </font>\n<br>constitution controller\n
给硫剂  	<br><font color=blue size=4>给硫剂  </font>\n<br>sulfur donor agent, sulfur donor\n
统计[结构]共聚物  	<br><font color=blue size=4>统计[结构]共聚物  </font>\n<br>statistical copolymer\n
统计线团  	<br><font color=blue size=4>统计线团  </font>\n<br>statistical coil\n
统计链段  	<br><font color=blue size=4>统计链段  </font>\n<br>statistical segment\n
维尼纶  	<br><font color=blue size=4>维尼纶  </font>\n<br>formalized PVA fiber\n
网络  	<br><font color=blue size=4>网络  </font>\n<br>network\n
网络密度  	<br><font color=blue size=4>网络密度  </font>\n<br>network density\n
网络聚合物  	<br><font color=blue size=4>网络聚合物  </font>\n<br>network polymer\n
线团状聚合物  	<br><font color=blue size=4>线团状聚合物  </font>\n<br>coilingtype polymer\n
线团-球粒转换  	<br><font color=blue size=4>线团-球粒转换  </font>\n<br>coil-globule transition\n
线型低密度聚乙烯  	<br><font color=blue size=4>线型低密度聚乙烯  </font>\n<br>linear low density polyethylene, LLDPE\n
线型聚合物  	<br><font color=blue size=4>线型聚合物  </font>\n<br>linear polymer\n
线性黏弹性  	<br><font color=blue size=4>线性黏弹性  </font>\n<br>linear viscoelasticity\n
缔合聚合物  	<br><font color=blue size=4>缔合聚合物  </font>\n<br>association polymer\n
缓聚作用  	<br><font color=blue size=4>缓聚作用  </font>\n<br>retardation\n
缓聚剂  	<br><font color=blue size=4>缓聚剂  </font>\n<br>retarder, retarding agent\n
缩丁醛树脂  	<br><font color=blue size=4>缩丁醛树脂  </font>\n<br>butyral resin\n
缩甲醛树脂  	<br><font color=blue size=4>缩甲醛树脂  </font>\n<br>methylal resin\n
缩聚反应  	<br><font color=blue size=4>缩聚反应  </font>\n<br>condensation polymerization，polycondensation\n
缩聚物  	<br><font color=blue size=4>缩聚物  </font>\n<br>polycondensate\n
缩醛树脂  	<br><font color=blue size=4>缩醛树脂  </font>\n<br>acetal resin\n
织构  	<br><font color=blue size=4>织构  </font>\n<br>texture\n
缨状微束模型  	<br><font color=blue size=4>缨状微束模型  </font>\n<br>fringed-micelle model\n
纤维  	<br><font color=blue size=4>纤维  </font>\n<br>fiber\n
纤维增强塑料  	<br><font color=blue size=4>纤维增强塑料  </font>\n<br>fiber reinforced plastic\n
纤维晶  	<br><font color=blue size=4>纤维晶  </font>\n<br>fibrous crystal\n
纤维素  	<br><font color=blue size=4>纤维素  </font>\n<br>cellulose\n
羟乙基纤维素  	<br><font color=blue size=4>羟乙基纤维素  </font>\n<br>hydroxyethyl cellulose\n
羧基丁腈橡胶  	<br><font color=blue size=4>羧基丁腈橡胶  </font>\n<br>carboxy terminated nitrile rubber\n
羧甲基纤维素  	<br><font color=blue size=4>羧甲基纤维素  </font>\n<br>carboxymethyl cellulose\n
聚1,2-二氯亚乙烯  	<br><font color=blue size=4>聚1,2-二氯亚乙烯  </font>\n<br>poly(vinylene chloride)\n
聚1-丁烯  	<br><font color=blue size=4>聚1-丁烯  </font>\n<br>poly(1-butene)\n
聚(1-辛烯)  	<br><font color=blue size=4>聚(1-辛烯)  </font>\n<br>poly(1-octene)\n
聚2-氨基戊二酸  	<br><font color=blue size=4>聚2-氨基戊二酸  </font>\n<br>poly(glutamic acid)\n
聚4-甲基-1-戊烯  	<br><font color=blue size=4>聚4-甲基-1-戊烯  </font>\n<br>poly(4-methyl-1-pentene)\n
聚丁二烯  	<br><font color=blue size=4>聚丁二烯  </font>\n<br>polybutadiene\n
聚三氟氯乙烯  	<br><font color=blue size=4>聚三氟氯乙烯  </font>\n<br>poly(chlorotrifluoroethylene), PCTFE\n
聚丙烯  	<br><font color=blue size=4>聚丙烯  </font>\n<br>polypropylene\n
聚丙烯纤维  	<br><font color=blue size=4>聚丙烯纤维  </font>\n<br>polypropylene fiber\n
聚丙烯腈  	<br><font color=blue size=4>聚丙烯腈  </font>\n<br>polyacrylonitrile\n
聚丙烯腈纤维  	<br><font color=blue size=4>聚丙烯腈纤维  </font>\n<br>acrylic fiber\n
聚丙烯酸  	<br><font color=blue size=4>聚丙烯酸  </font>\n<br>poly(acrylic acid)\n
聚丙烯酸酯  	<br><font color=blue size=4>聚丙烯酸酯  </font>\n<br>polyacrylate\n
聚丙烯酸盐  	<br><font color=blue size=4>聚丙烯酸盐  </font>\n<br>polyacrylate\n
聚乙二醇  	<br><font color=blue size=4>聚乙二醇  </font>\n<br>poly(oxyethylene glycol)\n
聚乙炔  	<br><font color=blue size=4>聚乙炔  </font>\n<br>polyacetylene\n
聚乙烯  	<br><font color=blue size=4>聚乙烯  </font>\n<br>polyethylene\n
聚乙烯醇  	<br><font color=blue size=4>聚乙烯醇  </font>\n<br>poly(vinyl alcohol)\n
聚乙烯醇缩丁醛  	<br><font color=blue size=4>聚乙烯醇缩丁醛  </font>\n<br>poly(vinyl butyral)\n
聚乙烯醇缩甲醛  	<br><font color=blue size=4>聚乙烯醇缩甲醛  </font>\n<br>poly(vinyl formal)\n
聚乙烯醇缩甲醛纤维  	<br><font color=blue size=4>聚乙烯醇缩甲醛纤维  </font>\n<br>formalized PVA fiber\n
聚乙烯醇纤维  	<br><font color=blue size=4>聚乙烯醇纤维  </font>\n<br>polyvinyl alcohol fiber\n
聚乙酸乙烯酯  	<br><font color=blue size=4>聚乙酸乙烯酯  </font>\n<br>poly(vinyl acetate)\n
聚乳酸  	<br><font color=blue size=4>聚乳酸  </font>\n<br>poly(lactic acid)，polylactide\n
聚二苯醚砜  	<br><font color=blue size=4>聚二苯醚砜  </font>\n<br>poly(diphenyl ether sulfone)\n
聚偏[二]氟乙烯  	<br><font color=blue size=4>聚偏[二]氟乙烯  </font>\n<br>poly(vinylidene fluoride)\n
聚偏二氟乙烯  	<br><font color=blue size=4>聚偏二氟乙烯  </font>\n<br>poly(vinylidene fluoride)\n
聚偏[二]氯乙烯  	<br><font color=blue size=4>聚偏[二]氯乙烯  </font>\n<br>poly(vinylidene chloride)\n
聚偏二氯乙烯  	<br><font color=blue size=4>聚偏二氯乙烯  </font>\n<br>poly(vinylidene chloride)\n
聚全氟丙烯  	<br><font color=blue size=4>聚全氟丙烯  </font>\n<br>poly(perfluoropropene)\n
聚加成反应  	<br><font color=blue size=4>聚加成反应  </font>\n<br>polyaddition\n
聚合  	<br><font color=blue size=4>聚合  </font>\n<br>polymerization\n
聚合催化剂  	<br><font color=blue size=4>聚合催化剂  </font>\n<br>polymerization catalyst\n
聚合加速剂  	<br><font color=blue size=4>聚合加速剂  </font>\n<br>polymerization accelerator\n
聚合动力学  	<br><font color=blue size=4>聚合动力学  </font>\n<br>polymerization kinetics\n
聚合度  	<br><font color=blue size=4>聚合度  </font>\n<br>degree of polymerization\n
聚合最高温度  	<br><font color=blue size=4>聚合最高温度  </font>\n<br>ceilling temperature of polymerization\n
聚合热  	<br><font color=blue size=4>聚合热  </font>\n<br>heat of polymerization\n
聚合热力学  	<br><font color=blue size=4>聚合热力学  </font>\n<br>polymerization thermodynamics\n
聚合物  	<br><font color=blue size=4>聚合物  </font>\n<br>polymer\n
聚合物形态学  	<br><font color=blue size=4>聚合物形态学  </font>\n<br>morphology of polymer\n
聚合物溶剂  	<br><font color=blue size=4>聚合物溶剂  </font>\n<br>polymer solvent\n
聚合物-溶剂相互作用  	<br><font color=blue size=4>聚合物-溶剂相互作用  </font>\n<br>polymer-solvent interaction\n
聚合物溶液  	<br><font color=blue size=4>聚合物溶液  </font>\n<br>polymer solution\n
聚合物-聚合物配合物  	<br><font color=blue size=4>聚合物-聚合物配合物  </font>\n<br>polymer-polymer complex\n
聚合物表面活性剂  	<br><font color=blue size=4>聚合物表面活性剂  </font>\n<br>polymeric surfactant\n
聚合物-金属配合物  	<br><font color=blue size=4>聚合物-金属配合物  </font>\n<br>polymer-metal complex\n
聚合物驻极体  	<br><font color=blue size=4>聚合物驻极体  </font>\n<br>polymer electret\n
聚喹喔啉  	<br><font color=blue size=4>聚喹喔啉  </font>\n<br>polyquinoxaline\n
聚四氟乙烯  	<br><font color=blue size=4>聚四氟乙烯  </font>\n<br>poly(tetrafluoroethylene)\n
聚四氢呋喃  	<br><font color=blue size=4>聚四氢呋喃  </font>\n<br>polytetrahydrofuran, polyoxytetramethylene\n
聚均苯四酰亚胺-1,4-亚苯  	<br><font color=blue size=4>聚均苯四酰亚胺-1,4-亚苯  </font>\n<br>poly(pyromellitimido-1,4-phenylene)\n
聚对亚苯  	<br><font color=blue size=4>聚对亚苯  </font>\n<br>poly(p-phenylene)\n
聚对亚苯硫醚  	<br><font color=blue size=4>聚对亚苯硫醚  </font>\n<br>poly(p-phenylene sulfide)\n
聚对苯二甲酸丁二酯  	<br><font color=blue size=4>聚对苯二甲酸丁二酯  </font>\n<br>poly(tetramethylene terephthalate), poly(butylene terephthalate)\n
聚对苯二甲酸乙二酯  	<br><font color=blue size=4>聚对苯二甲酸乙二酯  </font>\n<br>poly(ethylene terephthalate)\n
聚对苯二甲酸对苯二酯  	<br><font color=blue size=4>聚对苯二甲酸对苯二酯  </font>\n<br>poly(p-phenylene terephthalate)\n
聚己二酰己二胺  	<br><font color=blue size=4>聚己二酰己二胺  </font>\n<br>poly(hexamethylene adipamide)\n
聚己内酰胺  	<br><font color=blue size=4>聚己内酰胺  </font>\n<br>polycaprolactam\n
聚氟乙烯  	<br><font color=blue size=4>聚氟乙烯  </font>\n<br>poly(vinyl fluoride)\n
聚氨基甲酸酯  	<br><font color=blue size=4>聚氨基甲酸酯  </font>\n<br>polyurethane\n
聚氨酯  	<br><font color=blue size=4>聚氨酯  </font>\n<br>polyurethane\n
聚氨酯弹性纤维  	<br><font color=blue size=4>聚氨酯弹性纤维  </font>\n<br>polyurethane elastic fiber\n
聚氨酯橡胶  	<br><font color=blue size=4>聚氨酯橡胶  </font>\n<br>polyurethane rubber\n
聚氯丁二烯  	<br><font color=blue size=4>聚氯丁二烯  </font>\n<br>polychloroprene\n
聚氯乙烯  	<br><font color=blue size=4>聚氯乙烯  </font>\n<br>poly(vinyl chloride)\n
聚氯乙烯纤维  	<br><font color=blue size=4>聚氯乙烯纤维  </font>\n<br>polyvinyl chloride fiber\n
聚烯烃  	<br><font color=blue size=4>聚烯烃  </font>\n<br>polyolefin\n
聚环戊二烯  	<br><font color=blue size=4>聚环戊二烯  </font>\n<br>polycyclopentadiene\n
聚环氧丙烷  	<br><font color=blue size=4>聚环氧丙烷  </font>\n<br>poly(propylene oxide), 又称“聚氧化丙烯(polyoxytrimethyl-ene)”\n
聚环氧乙烷  	<br><font color=blue size=4>聚环氧乙烷  </font>\n<br>poly(ethylene oxide), 又称“聚氧化乙烯(polyoxyethylene)”\n
聚环氧氯丙烷  	<br><font color=blue size=4>聚环氧氯丙烷  </font>\n<br>polyepichlorohydrin\n
聚甘氨酸  	<br><font color=blue size=4>聚甘氨酸  </font>\n<br>polyglycine\n
聚甲基丙烯酸甲酯  	<br><font color=blue size=4>聚甲基丙烯酸甲酯  </font>\n<br>poly(methyl methacrylate)\n
聚甲基丙烯酸酯  	<br><font color=blue size=4>聚甲基丙烯酸酯  </font>\n<br>polymethacrylate\n
聚甲醛  	<br><font color=blue size=4>聚甲醛  </font>\n<br>polyoxymethylene, polyformaldehyde\n
聚异丁烯  	<br><font color=blue size=4>聚异丁烯  </font>\n<br>polyisobutylene\n
聚异戊二烯  	<br><font color=blue size=4>聚异戊二烯  </font>\n<br>polyisoprene\n
聚硫化物  	<br><font color=blue size=4>聚硫化物  </font>\n<br>polysulfide\n
聚硫橡胶  	<br><font color=blue size=4>聚硫橡胶  </font>\n<br>polysulfide rubber\n
聚硫醚  	<br><font color=blue size=4>聚硫醚  </font>\n<br>polythioether\n
聚碳酸酯  	<br><font color=blue size=4>聚碳酸酯  </font>\n<br>polycarbonate\n
聚砜  	<br><font color=blue size=4>聚砜  </font>\n<br>polysulfone\n
聚谷氨酸  	<br><font color=blue size=4>聚谷氨酸  </font>\n<br>poly(glutamic acid)\n
聚羧酸酯  	<br><font color=blue size=4>聚羧酸酯  </font>\n<br>polycarboxylate\n
聚胱氨酸  	<br><font color=blue size=4>聚胱氨酸  </font>\n<br>polycysteine\n
聚脲  	<br><font color=blue size=4>聚脲  </font>\n<br>polyurea\n
聚脲树脂  	<br><font color=blue size=4>聚脲树脂  </font>\n<br>carbamide resin, 又叫“碳酰胺树脂”\n
聚芳砜  	<br><font color=blue size=4>聚芳砜  </font>\n<br>poly(aryl sulfone)  (PAS)\n
聚芳砜酰胺  	<br><font color=blue size=4>聚芳砜酰胺  </font>\n<br>aromatic polysulfonamide\n
聚芳酰胺  	<br><font color=blue size=4>聚芳酰胺  </font>\n<br>polyaramide, aromatic polyamide\n
聚芳酰胺纤维  	<br><font color=blue size=4>聚芳酰胺纤维  </font>\n<br>aramid fiber\n
聚苯并咪唑  	<br><font color=blue size=4>聚苯并咪唑  </font>\n<br>polybenzimidazole\n
聚苯并噻唑  	<br><font color=blue size=4>聚苯并噻唑  </font>\n<br>polybenzothiazole\n
聚苯乙烯  	<br><font color=blue size=4>聚苯乙烯  </font>\n<br>polystyrene\n
聚苯硫醚  	<br><font color=blue size=4>聚苯硫醚  </font>\n<br>poly(p-phenylene sulfide)（俗称）\n
聚苯胺  	<br><font color=blue size=4>聚苯胺  </font>\n<br>polyaniline\n
聚苯醚  	<br><font color=blue size=4>聚苯醚  </font>\n<br>polyphenylene oxide, 又称“聚亚苯醚”\n
聚酯  	<br><font color=blue size=4>聚酯  </font>\n<br>polyester\n
聚酯纤维  	<br><font color=blue size=4>聚酯纤维  </font>\n<br>polyester fiber\n
聚酯类树脂  	<br><font color=blue size=4>聚酯类树脂  </font>\n<br>polyester resin\n
聚酰亚胺  	<br><font color=blue size=4>聚酰亚胺  </font>\n<br>polyimide\n
聚酰胺  	<br><font color=blue size=4>聚酰胺  </font>\n<br>polyamide\n
聚酰胺3  	<br><font color=blue size=4>聚酰胺3  </font>\n<br>poly(β alanine)\n
聚酰胺6  	<br><font color=blue size=4>聚酰胺6  </font>\n<br>poly(ω amino caproic acid)\n
聚酰胺8  	<br><font color=blue size=4>聚酰胺8  </font>\n<br>poly(8 amino caprylic acid)\n
聚酰胺纤维  	<br><font color=blue size=4>聚酰胺纤维  </font>\n<br>polyamide fiber\n
聚醋酸乙烯酯  	<br><font color=blue size=4>聚醋酸乙烯酯  </font>\n<br>poly(vinyl acetate)\n
聚醚  	<br><font color=blue size=4>聚醚  </font>\n<br>polyether\n
聚醚氨酯  	<br><font color=blue size=4>聚醚氨酯  </font>\n<br>poly(ether-urethane)\n
聚醚砜  	<br><font color=blue size=4>聚醚砜  </font>\n<br>poly(ether sulfone)\n
聚醚酮  	<br><font color=blue size=4>聚醚酮  </font>\n<br>poly(ether-ketone), PEK\n
聚醚酮酮  	<br><font color=blue size=4>聚醚酮酮  </font>\n<br>poly(ether-ketone-ketone), PEKK\n
聚醚酰胺  	<br><font color=blue size=4>聚醚酰胺  </font>\n<br>poly(ether amide)\n
聚醚醚酮  	<br><font color=blue size=4>聚醚醚酮  </font>\n<br>poly(ether-ether-ketone), PEEK\n
聚降冰片烯  	<br><font color=blue size=4>聚降冰片烯  </font>\n<br>polynorbornene\n
聚集  	<br><font color=blue size=4>聚集  </font>\n<br>aggregation, coalescence\n
聚集体  	<br><font color=blue size=4>聚集体  </font>\n<br>aggregate\n
聚电解质  	<br><font color=blue size=4>聚电解质  </font>\n<br>polyelectrolyte\n
聚（8-氨基辛酸）  	<br><font color=blue size=4>聚（8-氨基辛酸）  </font>\n<br>poly(8 amino caprylic acid)\n
聚（β-氨基丙酸）  	<br><font color=blue size=4>聚（β-氨基丙酸）  </font>\n<br>poly(β alanine)\n
聚（ω-氨基己酸）  	<br><font color=blue size=4>聚（ω-氨基己酸）  </font>\n<br>poly(ω amino caproic acid)\n
股  	<br><font color=blue size=4>股  </font>\n<br>strand\n
胺纤维素  	<br><font color=blue size=4>胺纤维素  </font>\n<br>amine cellulose\n
脂肪族环氧树脂  	<br><font color=blue size=4>脂肪族环氧树脂  </font>\n<br>aliphatic epoxy resin\n
脂肪族聚酯  	<br><font color=blue size=4>脂肪族聚酯  </font>\n<br>aliphatic polyester\n
脆化温度  	<br><font color=blue size=4>脆化温度  </font>\n<br>brittleness(brittle) temperature\n
脆性断裂  	<br><font color=blue size=4>脆性断裂  </font>\n<br>brittle fracture\n
脆性开裂  	<br><font color=blue size=4>脆性开裂  </font>\n<br>brittle cracking\n
脆-韧转变  	<br><font color=blue size=4>脆-韧转变  </font>\n<br>brittle ductile transition\n
脱模剂  	<br><font color=blue size=4>脱模剂  </font>\n<br>releasing agent\n
脱氧核糖核酸  	<br><font color=blue size=4>脱氧核糖核酸  </font>\n<br>deoxyribonucleic acid（DNA）\n
脲醛树脂  	<br><font color=blue size=4>脲醛树脂  </font>\n<br>urea-formaldehyde resin\n
腈纶  	<br><font color=blue size=4>腈纶  </font>\n<br>acrylic fiber\n
胶乳  	<br><font color=blue size=4>胶乳  </font>\n<br>latex\n
胶溶剂  	<br><font color=blue size=4>胶溶剂  </font>\n<br>peptizer\n
胶粘剂  	<br><font color=blue size=4>胶粘剂  </font>\n<br>adhesive\n
临界分子量  	<br><font color=blue size=4>临界分子量  </font>\n<br>critical molecular weight\n
临界聚集浓度  	<br><font color=blue size=4>临界聚集浓度  </font>\n<br>critical aggregation concentration\n
临界胶束浓度  	<br><font color=blue size=4>临界胶束浓度  </font>\n<br>critical micelle concentration，CMC\n
自交联  	<br><font color=blue size=4>自交联  </font>\n<br>self crosslinking , self curing\n
自催化缩聚  	<br><font color=blue size=4>自催化缩聚  </font>\n<br>autocatalytic polycondensation\n
自动加速效应  	<br><font color=blue size=4>自动加速效应  </font>\n<br>autoacceleration effect\n
自动硫化  	<br><font color=blue size=4>自动硫化  </font>\n<br>self-curing, self-vulcanizing\n
自增强聚合物  	<br><font color=blue size=4>自增强聚合物  </font>\n<br>self-reinforcing polymer\n
自增长  	<br><font color=blue size=4>自增长  </font>\n<br>self propagation\n
自由基共聚合  	<br><font color=blue size=4>自由基共聚合  </font>\n<br>radical copolymerization\n
自由基寿命  	<br><font color=blue size=4>自由基寿命  </font>\n<br>free radical lifetime\n
自由基引发剂  	<br><font color=blue size=4>自由基引发剂  </font>\n<br>radical initiator\n
自由基捕获剂  	<br><font color=blue size=4>自由基捕获剂  </font>\n<br>radical scavenger\n
自由基异构化聚合  	<br><font color=blue size=4>自由基异构化聚合  </font>\n<br>free radical isomerization polymerization\n
自由基聚合  	<br><font color=blue size=4>自由基聚合  </font>\n<br>free radical polymerization, radical polymerization\n
自由基链降解  	<br><font color=blue size=4>自由基链降解  </font>\n<br>free radical chain degradation\n
自由基开环聚合  	<br><font color=blue size=4>自由基开环聚合  </font>\n<br>radical ring opening polymerization\n
自由旋转链  	<br><font color=blue size=4>自由旋转链  </font>\n<br>freely-rotating chain\n
自由连接链  	<br><font color=blue size=4>自由连接链  </font>\n<br>freely-jointed chain\n
自发终止  	<br><font color=blue size=4>自发终止  </font>\n<br>spontaneous termination\n
自发聚合  	<br><font color=blue size=4>自发聚合  </font>\n<br>spontaneous polymerization\n
自硫[化]  	<br><font color=blue size=4>自硫[化]  </font>\n<br>bin cure\n
自终止  	<br><font color=blue size=4>自终止  </font>\n<br>self termination\n
自组装  	<br><font color=blue size=4>自组装  </font>\n<br>self assembly\n
自避随机行走模型  	<br><font color=blue size=4>自避随机行走模型  </font>\n<br>self avoiding walk model\n
舒尔茨-齐姆分布  	<br><font color=blue size=4>舒尔茨-齐姆分布  </font>\n<br>Schulz-Zimm distribution\n
良溶剂  	<br><font color=blue size=4>良溶剂  </font>\n<br>good solvent\n
色料  	<br><font color=blue size=4>色料  </font>\n<br>colorant\n
色谱分级  	<br><font color=blue size=4>色谱分级  </font>\n<br>chromatographic fractionation\n
花菜状聚合物  	<br><font color=blue size=4>花菜状聚合物  </font>\n<br>cauliflower polymer\n
芳纶  	<br><font color=blue size=4>芳纶  </font>\n<br>aramid fiber\n
芳香尼龙  	<br><font color=blue size=4>芳香尼龙  </font>\n<br>aramid fiber\n
芳香族聚酯  	<br><font color=blue size=4>芳香族聚酯  </font>\n<br>aromatic polyester\n
芳香族聚醚  	<br><font color=blue size=4>芳香族聚醚  </font>\n<br>poly (aryl ether)\n
苯并呋喃-茚树脂  	<br><font color=blue size=4>苯并呋喃-茚树脂  </font>\n<br>coumarone-indene resin\n
苯乙烯-丁二烯-苯乙烯嵌段共聚物  	<br><font color=blue size=4>苯乙烯-丁二烯-苯乙烯嵌段共聚物  </font>\n<br>styrene butadiene styrene block copolymer (SBS)\n
苯乙烯-异戊二烯-丁二烯橡胶  	<br><font color=blue size=4>苯乙烯-异戊二烯-丁二烯橡胶  </font>\n<br>styrene isoprene butadiene rubber (SIBR)\n
苯乙烯-异戊二烯-苯乙烯嵌段共聚物  	<br><font color=blue size=4>苯乙烯-异戊二烯-苯乙烯嵌段共聚物  </font>\n<br>styrene isoprene styrene block copolymer (SIS)\n
苯酚醚树脂  	<br><font color=blue size=4>苯酚醚树脂  </font>\n<br>phenol ether resin\n
苯醌聚合物  	<br><font color=blue size=4>苯醌聚合物  </font>\n<br>quinone polymer\n
茂金属催化剂  	<br><font color=blue size=4>茂金属催化剂  </font>\n<br>metallocene catalyst\n
茚树脂  	<br><font color=blue size=4>茚树脂  </font>\n<br>indene resin\n
萃取分级  	<br><font color=blue size=4>萃取分级  </font>\n<br>extraction fractionation\n
萜烯树脂  	<br><font color=blue size=4>萜烯树脂  </font>\n<br>terpene resin\n
落球黏度  	<br><font color=blue size=4>落球黏度  </font>\n<br>ball viscosity\n
落球黏度计  	<br><font color=blue size=4>落球黏度计  </font>\n<br>ball viscometer\n
着色剂  	<br><font color=blue size=4>着色剂  </font>\n<br>colorant\n
葡聚糖  	<br><font color=blue size=4>葡聚糖  </font>\n<br>dextran, 又称“右旋糖酐”\n
蒙特卡洛模拟  	<br><font color=blue size=4>蒙特卡洛模拟  </font>\n<br>Monte Carlo simulation\n
蒸气压渗透法  	<br><font color=blue size=4>蒸气压渗透法  </font>\n<br>vapor pressure osmometry, VPO\n
蒸汽硫化  	<br><font color=blue size=4>蒸汽硫化  </font>\n<br>steam curing\n
苏型双全同立构聚合物  	<br><font color=blue size=4>苏型双全同立构聚合物  </font>\n<br>threo-diisotactic polymer\n
苏型双间同立构聚合物  	<br><font color=blue size=4>苏型双间同立构聚合物  </font>\n<br>threo-disyndiotactic polymer\n
螯合型树脂  	<br><font color=blue size=4>螯合型树脂  </font>\n<br>chelating resin\n
螯合型离子交换剂  	<br><font color=blue size=4>螯合型离子交换剂  </font>\n<br>chelating ion-exchanger\n
螯合聚合物  	<br><font color=blue size=4>螯合聚合物  </font>\n<br>chelate polymer\n
螺旋形聚合物  	<br><font color=blue size=4>螺旋形聚合物  </font>\n<br>helical polymer\n
螺旋链  	<br><font color=blue size=4>螺旋链  </font>\n<br>helix chain\n
虫胶  	<br><font color=blue size=4>虫胶  </font>\n<br>shellac\n
蠕虫状链  	<br><font color=blue size=4>蠕虫状链  </font>\n<br>worm-like chain\n
蠕变  	<br><font color=blue size=4>蠕变  </font>\n<br>creep\n
蠕变柔量  	<br><font color=blue size=4>蠕变柔量  </font>\n<br>creep compliance\n
蚕丝  	<br><font color=blue size=4>蚕丝  </font>\n<br>natural silk\n
血液兼容性  	<br><font color=blue size=4>血液兼容性  </font>\n<br>blood compatibility\n
表观分子量  	<br><font color=blue size=4>表观分子量  </font>\n<br>apparent molecular weight\n
表观剪切黏度  	<br><font color=blue size=4>表观剪切黏度  </font>\n<br>apparent shear viscosity\n
表观摩尔质量  	<br><font color=blue size=4>表观摩尔质量  </font>\n<br>apparent molar mass\n
袋模塑  	<br><font color=blue size=4>袋模塑  </font>\n<br>bag molding\n
裂缝  	<br><font color=blue size=4>裂缝  </font>\n<br>crack\n
补强剂  	<br><font color=blue size=4>补强剂  </font>\n<br>reinforcing agent\n
复合引发体系  	<br><font color=blue size=4>复合引发体系  </font>\n<br>complex initiation system\n
复合成型  	<br><font color=blue size=4>复合成型  </font>\n<br>composite molding\n
复合材料  	<br><font color=blue size=4>复合材料  </font>\n<br>composite\n
复合纺丝  	<br><font color=blue size=4>复合纺丝  </font>\n<br>conjugate spinning\n
复数介电常数  	<br><font color=blue size=4>复数介电常数  </font>\n<br>complex dielectric permittivity\n
复数柔量  	<br><font color=blue size=4>复数柔量  </font>\n<br>complex compliance\n
复数模量  	<br><font color=blue size=4>复数模量  </font>\n<br>complex modulus\n
复数黏度  	<br><font color=blue size=4>复数黏度  </font>\n<br>complex viscosity\n
复丝  	<br><font color=blue size=4>复丝  </font>\n<br>multifilament\n
规整嵌段  	<br><font color=blue size=4>规整嵌段  </font>\n<br>regular block\n
规整聚合物  	<br><font color=blue size=4>规整聚合物  </font>\n<br>regular polymer\n
亲水聚合物  	<br><font color=blue size=4>亲水聚合物  </font>\n<br>hydrophilic polymer\n
解偏振作用  	<br><font color=blue size=4>解偏振作用  </font>\n<br>depolarization\n
解取向  	<br><font color=blue size=4>解取向  </font>\n<br>disorientation\n
解聚  	<br><font color=blue size=4>解聚  </font>\n<br>depolymerization\n
解聚酶  	<br><font color=blue size=4>解聚酶  </font>\n<br>depolymerase\n
触压成型  	<br><font color=blue size=4>触压成型  </font>\n<br>impression molding\n
触变性  	<br><font color=blue size=4>触变性  </font>\n<br>thixotropy\n
计算器模拟  	<br><font color=blue size=4>计算器模拟  </font>\n<br>computer simulation\n
诱导分解  	<br><font color=blue size=4>诱导分解  </font>\n<br>induced decomposition\n
诱导期  	<br><font color=blue size=4>诱导期  </font>\n<br>induction period\n
调聚反应  	<br><font color=blue size=4>调聚反应  </font>\n<br>telomerization\n
调聚物  	<br><font color=blue size=4>调聚物  </font>\n<br>telomer\n
变形  	<br><font color=blue size=4>变形  </font>\n<br>deformation\n
负离子交换树脂  	<br><font color=blue size=4>负离子交换树脂  </font>\n<br>anion exchange resin\n
负离子交换膜  	<br><font color=blue size=4>负离子交换膜  </font>\n<br>anionic exchange membrane\n
负离子引发剂  	<br><font color=blue size=4>负离子引发剂  </font>\n<br>ionioic initiator\n
负离子环化聚合  	<br><font color=blue size=4>负离子环化聚合  </font>\n<br>anionic cyclopolymerization\n
负离子异构化聚合  	<br><font color=blue size=4>负离子异构化聚合  </font>\n<br>anionic isomerization polymerization\n
负离子聚合  	<br><font color=blue size=4>负离子聚合  </font>\n<br>anionic polymerization\n
负离子自由基引发剂  	<br><font color=blue size=4>负离子自由基引发剂  </font>\n<br>anion radical initiator\n
负离子电化学聚合  	<br><font color=blue size=4>负离子电化学聚合  </font>\n<br>anionic electrochemical polymerization\n
宾汉姆流体  	<br><font color=blue size=4>宾汉姆流体  </font>\n<br>Bingham fluid\n
质量分布函数  	<br><font color=blue size=4>质量分布函数  </font>\n<br>mass distribution function\n
赤型双全同立构聚合物  	<br><font color=blue size=4>赤型双全同立构聚合物  </font>\n<br>erythro-diisotactic polymer\n
赤型双间同立构聚合物  	<br><font color=blue size=4>赤型双间同立构聚合物  </font>\n<br>erythro-disyndiotactic polymer\n
起球现象  	<br><font color=blue size=4>起球现象  </font>\n<br>pilling effect\n
超低密度聚乙烯  	<br><font color=blue size=4>超低密度聚乙烯  </font>\n<br>ultra low density polyethylene, ULDPE\n
超导聚合物  	<br><font color=blue size=4>超导聚合物  </font>\n<br>superconductive polymer\n
超支化聚合物  	<br><font color=blue size=4>超支化聚合物  </font>\n<br>hyperbranched polymer\n
超瑞利比  	<br><font color=blue size=4>超瑞利比  </font>\n<br>excess Rayleigh ratio\n
超离子导电聚合物  	<br><font color=blue size=4>超离子导电聚合物  </font>\n<br>super ion-conductive polymer\n
超高分子  	<br><font color=blue size=4>超高分子  </font>\n<br>supra polymer\n
超高分子量聚乙烯  	<br><font color=blue size=4>超高分子量聚乙烯  </font>\n<br>ultrahigh molecular weight polyethylene, UHMWPE\n
软化温度  	<br><font color=blue size=4>软化温度  </font>\n<br>softening temperature\n
轴晶  	<br><font color=blue size=4>轴晶  </font>\n<br>axialite\n
辅增塑剂  	<br><font color=blue size=4>辅增塑剂  </font>\n<br>coplasticizer\n
辐射交联  	<br><font color=blue size=4>辐射交联  </font>\n<br>radiation crosslinking\n
辐射固化聚合物  	<br><font color=blue size=4>辐射固化聚合物  </font>\n<br>radiation curable polymer\n
辐射引发聚合  	<br><font color=blue size=4>辐射引发聚合  </font>\n<br>radiation initiated polymerization\n
辐射的相干弹性散射  	<br><font color=blue size=4>辐射的相干弹性散射  </font>\n<br>coherent elastic scattering of radiation\n
辐射硫化  	<br><font color=blue size=4>辐射硫化  </font>\n<br>radiation vulcanization\n
辐射诱导接枝  	<br><font color=blue size=4>辐射诱导接枝  </font>\n<br>radiation induced grafting\n
辐射降解  	<br><font color=blue size=4>辐射降解  </font>\n<br>radiation degradation\n
辐射降解聚合物  	<br><font color=blue size=4>辐射降解聚合物  </font>\n<br>radiation-degradable polymer\n
辐射离子聚合  	<br><font color=blue size=4>辐射离子聚合  </font>\n<br>radiation ion polymerization\n
近晶中介相  	<br><font color=blue size=4>近晶中介相  </font>\n<br>smectic mesophase\n
近晶相  	<br><font color=blue size=4>近晶相  </font>\n<br>smectic phase\n
近晶相液晶  	<br><font color=blue size=4>近晶相液晶  </font>\n<br>smectic liquid crystal\n
近程分子内相互作用  	<br><font color=blue size=4>近程分子内相互作用  </font>\n<br>short-range intramolecular interaction\n
近程有序  	<br><font color=blue size=4>近程有序  </font>\n<br>short range order\n
近程结构  	<br><font color=blue size=4>近程结构  </font>\n<br>short-range structure\n
返硫  	<br><font color=blue size=4>返硫  </font>\n<br>reversion\n
退化  	<br><font color=blue size=4>退化  </font>\n<br>degradation\n
退化链转移  	<br><font color=blue size=4>退化链转移  </font>\n<br>degradation (degradative) chain transfer\n
逐步共聚合  	<br><font color=blue size=4>逐步共聚合  </font>\n<br>step copolymerization\n
逐步加成聚合  	<br><font color=blue size=4>逐步加成聚合  </font>\n<br>polyaddition (曾用名)\n
逐步［增长］聚合  	<br><font color=blue size=4>逐步［增长］聚合  </font>\n<br>step growth polymerization\n
通用高分子  	<br><font color=blue size=4>通用高分子  </font>\n<br>commodity polymer\n
连续硫化  	<br><font color=blue size=4>连续硫化  </font>\n<br>continuous vulcanization\n
连续聚合  	<br><font color=blue size=4>连续聚合  </font>\n<br>continuous polymerization\n
游离基聚合  	<br><font color=blue size=4>游离基聚合  </font>\n<br>free radical polymerization, radical polymerization (曾用名)\n
过早硫化  	<br><font color=blue size=4>过早硫化  </font>\n<br>scorching\n
过氧化物交联  	<br><font color=blue size=4>过氧化物交联  </font>\n<br>peroxide crosslinking\n
过氧化苯甲酰  	<br><font color=blue size=4>过氧化苯甲酰  </font>\n<br>benzoyl peroxide, BPO\n
过渡金属催化剂  	<br><font color=blue size=4>过渡金属催化剂  </font>\n<br>transition metal catalyst\n
过炼  	<br><font color=blue size=4>过炼  </font>\n<br>dead milled\n
过硫  	<br><font color=blue size=4>过硫  </font>\n<br>over cure\n
过硫酸盐引发剂  	<br><font color=blue size=4>过硫酸盐引发剂  </font>\n<br>persulphate initiator\n
遥爪聚合物  	<br><font color=blue size=4>遥爪聚合物  </font>\n<br>telechelic polymer\n
递变嵌段共聚物  	<br><font color=blue size=4>递变嵌段共聚物  </font>\n<br>tapered block copolymer\n
远程分子内相互作用  	<br><font color=blue size=4>远程分子内相互作用  </font>\n<br>long-range intramolecular interaction\n
远程结构  	<br><font color=blue size=4>远程结构  </font>\n<br>long-range structure\n
远螯聚合物  	<br><font color=blue size=4>远螯聚合物  </font>\n<br>telechelic polymer\n
部分梯形聚合物  	<br><font color=blue size=4>部分梯形聚合物  </font>\n<br>partial ladder polymer\n
配位正离子聚合  	<br><font color=blue size=4>配位正离子聚合  </font>\n<br>coordinated cationic polymerization\n
配位聚合  	<br><font color=blue size=4>配位聚合  </font>\n<br>coordination polymerization\n
配位聚合物  	<br><font color=blue size=4>配位聚合物  </font>\n<br>coordination polymer\n
配位负离子聚合  	<br><font color=blue size=4>配位负离子聚合  </font>\n<br>coordinated anionic polymerization\n
配位离子聚合  	<br><font color=blue size=4>配位离子聚合  </font>\n<br>coordinated ionic polymerization\n
酚醛树脂  	<br><font color=blue size=4>酚醛树脂  </font>\n<br>phenol-formaldehyde resin, phenolic resin\n
酯交换型聚合  	<br><font color=blue size=4>酯交换型聚合  </font>\n<br>transesterification type polymerization, ester exchange polycondensation\n
酶聚合作用  	<br><font color=blue size=4>酶聚合作用  </font>\n<br>enzymatic polymerization\n
醇酸树脂  	<br><font color=blue size=4>醇酸树脂  </font>\n<br>alkyd resin\n
醋酸纤维素  	<br><font color=blue size=4>醋酸纤维素  </font>\n<br>cellulose acetate\n
醛类聚合物  	<br><font color=blue size=4>醛类聚合物  </font>\n<br>aldehyde polymer\n
医用高分子  	<br><font color=blue size=4>医用高分子  </font>\n<br>medical polymer\n
重均分子量  	<br><font color=blue size=4>重均分子量  </font>\n<br>weight-average molecular weight, weight-average molar mass\n
重复结构单元  	<br><font color=blue size=4>重复结构单元  </font>\n<br>constitutional repeating unit\n
重量分布函数  	<br><font color=blue size=4>重量分布函数  </font>\n<br>weight distribution function\n
金属有机聚合物  	<br><font color=blue size=4>金属有机聚合物  </font>\n<br>organometallic polymer\n
金属络合物催化剂  	<br><font color=blue size=4>金属络合物催化剂  </font>\n<br>metal complex catalyst\n
钛酸酯偶联剂  	<br><font color=blue size=4>钛酸酯偶联剂  </font>\n<br>titanate coupling agent\n
银纹  	<br><font color=blue size=4>银纹  </font>\n<br>craze\n
铝酸酯偶联剂  	<br><font color=blue size=4>铝酸酯偶联剂  </font>\n<br>aluminate coupling agent\n
锯齿链  	<br><font color=blue size=4>锯齿链  </font>\n<br>zigzag chain\n
锥形共聚物  	<br><font color=blue size=4>锥形共聚物  </font>\n<br>tapered copolymer\n
锦纶  	<br><font color=blue size=4>锦纶  </font>\n<br>polyamide fiber\n
链刚性  	<br><font color=blue size=4>链刚性  </font>\n<br>chain rigidity\n
链取向无序  	<br><font color=blue size=4>链取向无序  </font>\n<br>chain orientational disorder\n
链型聚合物  	<br><font color=blue size=4>链型聚合物  </font>\n<br>chain polymer\n
链增长  	<br><font color=blue size=4>链增长  </font>\n<br>chain growth, chain propagation\n
链增长剂  	<br><font color=blue size=4>链增长剂  </font>\n<br>chain extender\n
链大尺度取向  	<br><font color=blue size=4>链大尺度取向  </font>\n<br>global chain orientation\n
链引发  	<br><font color=blue size=4>链引发  </font>\n<br>chain initiation\n
链折迭  	<br><font color=blue size=4>链折迭  </font>\n<br>chain folding\n
链支化  	<br><font color=blue size=4>链支化  </font>\n<br>chain branching\n
链断裂  	<br><font color=blue size=4>链断裂  </font>\n<br>chain breaking\n
链末端  	<br><font color=blue size=4>链末端  </font>\n<br>chain end\n
链柔性  	<br><font color=blue size=4>链柔性  </font>\n<br>chain flexibility\n
链构象  	<br><font color=blue size=4>链构象  </font>\n<br>chain conformation\n
链段  	<br><font color=blue size=4>链段  </font>\n<br>chain segment\n
链段运动  	<br><font color=blue size=4>链段运动  </font>\n<br>segmental motion\n
链终止  	<br><font color=blue size=4>链终止  </font>\n<br>chain termination\n
链终止剂  	<br><font color=blue size=4>链终止剂  </font>\n<br>chain terminating agent\n
链缠结  	<br><font color=blue size=4>链缠结  </font>\n<br>chain entanglement\n
链轴  	<br><font color=blue size=4>链轴  </font>\n<br>chain axis\n
链转移  	<br><font color=blue size=4>链转移  </font>\n<br>chain transfer\n
链转移剂  	<br><font color=blue size=4>链转移剂  </font>\n<br>chain transfer agent\n
链转移常数  	<br><font color=blue size=4>链转移常数  </font>\n<br>chain transfer constant\n
链重复距离  	<br><font color=blue size=4>链重复距离  </font>\n<br>chain repeating distance\n
链间相互作用  	<br><font color=blue size=4>链间相互作用  </font>\n<br>interchain interaction\n
链间距  	<br><font color=blue size=4>链间距  </font>\n<br>interchain spacing\n
链骨架  	<br><font color=blue size=4>链骨架  </font>\n<br>chain backbone\n
链［式］聚合  	<br><font color=blue size=4>链［式］聚合  </font>\n<br>chain polymerization\n
铁磁聚合物  	<br><font color=blue size=4>铁磁聚合物  </font>\n<br>ferromagnetic polymer\n
铁电聚合物  	<br><font color=blue size=4>铁电聚合物  </font>\n<br>ferroelectric polymer\n
铸塑  	<br><font color=blue size=4>铸塑  </font>\n<br>cast\n
铸塑成型  	<br><font color=blue size=4>铸塑成型  </font>\n<br>cast molding\n
铸塑聚合  	<br><font color=blue size=4>铸塑聚合  </font>\n<br>cast polymerization\n
镶铸  	<br><font color=blue size=4>镶铸  </font>\n<br>imbedding\n
长周期  	<br><font color=blue size=4>长周期  </font>\n<br>long period\n
长支链  	<br><font color=blue size=4>长支链  </font>\n<br>long-chain branch\n
长支链聚乙烯  	<br><font color=blue size=4>长支链聚乙烯  </font>\n<br>long chain branched polyethylene\n
长程有序  	<br><font color=blue size=4>长程有序  </font>\n<br>long range order\n
门尼粘度  	<br><font color=blue size=4>门尼粘度  </font>\n<br>Mooney index\n
闪发聚合  	<br><font color=blue size=4>闪发聚合  </font>\n<br>flash polymerization\n
开始[硫化]效应  	<br><font color=blue size=4>开始[硫化]效应  </font>\n<br>set-up effect\n
开尔文模型  	<br><font color=blue size=4>开尔文模型  </font>\n<br>Kelvin model\n
开环共聚合  	<br><font color=blue size=4>开环共聚合  </font>\n<br>ring opening copolymerization\n
开环易位聚合  	<br><font color=blue size=4>开环易位聚合  </font>\n<br>ring opening metathesis polymerization，ROMP\n
开环聚合  	<br><font color=blue size=4>开环聚合  </font>\n<br>ring opening polymerization\n
开环聚环烯烃  	<br><font color=blue size=4>开环聚环烯烃  </font>\n<br>polyalkenamer, 对于环烯烃的聚合产物，由于聚合机理的不同，一种是开环聚合，一种是保留环打开双键的聚合\n
间同度  	<br><font color=blue size=4>间同度  </font>\n<br>syndiotacticity\n
间同立构聚合物  	<br><font color=blue size=4>间同立构聚合物  </font>\n<br>syndiotactic polymer\n
间同立构[规整]度  	<br><font color=blue size=4>间同立构[规整]度  </font>\n<br>syndiotacticity\n
间歇聚合  	<br><font color=blue size=4>间歇聚合  </font>\n<br>batch polymerization\n
间规聚合物  	<br><font color=blue size=4>间规聚合物  </font>\n<br>syndiotactic polymer\n
防潮剂  	<br><font color=blue size=4>防潮剂  </font>\n<br>moisture proof agent\n
防火剂  	<br><font color=blue size=4>防火剂  </font>\n<br>fire retardant\n
防焦剂  	<br><font color=blue size=4>防焦剂  </font>\n<br>scorch retarder\n
防粘剂  	<br><font color=blue size=4>防粘剂  </font>\n<br>releasing agent\n
防结皮剂  	<br><font color=blue size=4>防结皮剂  </font>\n<br>anti-skinning agent\n
防缩  	<br><font color=blue size=4>防缩  </font>\n<br>non-shrink\n
防老剂  	<br><font color=blue size=4>防老剂  </font>\n<br>anti-aging agent\n
防腐剂  	<br><font color=blue size=4>防腐剂  </font>\n<br>rot resistor\n
防臭氧剂  	<br><font color=blue size=4>防臭氧剂  </font>\n<br>antiozonant\n
防蚀剂  	<br><font color=blue size=4>防蚀剂  </font>\n<br>anti-corrosion agent\n
防霉剂  	<br><font color=blue size=4>防霉剂  </font>\n<br>antiseptic\n
阻滞剂  	<br><font color=blue size=4>阻滞剂  </font>\n<br>retarding agent\n
阻燃剂  	<br><font color=blue size=4>阻燃剂  </font>\n<br>flame retardant\n
阻聚作用  	<br><font color=blue size=4>阻聚作用  </font>\n<br>inhibition\n
阻聚剂  	<br><font color=blue size=4>阻聚剂  </font>\n<br>inhibitor\n
阻透聚合物  	<br><font color=blue size=4>阻透聚合物  </font>\n<br>barrier polymer\n
阻黏剂  	<br><font color=blue size=4>阻黏剂  </font>\n<br>abhesive\n
阿夫拉米方程  	<br><font color=blue size=4>阿夫拉米方程  </font>\n<br>Avrami equation\n
附生晶体生长  	<br><font color=blue size=4>附生晶体生长  </font>\n<br>epitaxial growth\n
附生结晶  	<br><font color=blue size=4>附生结晶  </font>\n<br>epitaxial crystallization\n
附聚剂  	<br><font color=blue size=4>附聚剂  </font>\n<br>agglomerating agent\n
降解  	<br><font color=blue size=4>降解  </font>\n<br>degradation\n
降解性高分子  	<br><font color=blue size=4>降解性高分子  </font>\n<br>degradable polymer\n
限定几何构型茂金属催化剂  	<br><font color=blue size=4>限定几何构型茂金属催化剂  </font>\n<br>constrained geometry metallocene catalyst\n
除臭剂  	<br><font color=blue size=4>除臭剂  </font>\n<br>re-odorant\n
阴离子聚合  	<br><font color=blue size=4>阴离子聚合  </font>\n<br>anionic polymerization\n
阳离子聚合  	<br><font color=blue size=4>阳离子聚合  </font>\n<br>cationic polymerization\n
隔离剂  	<br><font color=blue size=4>隔离剂  </font>\n<br>separant\n
集成橡胶  	<br><font color=blue size=4>集成橡胶  </font>\n<br>integrated rubber\n
双分子终止  	<br><font color=blue size=4>双分子终止  </font>\n<br>bimolecular termination\n
双官能引发剂  	<br><font color=blue size=4>双官能引发剂  </font>\n<br>bifunctional initiator， difunctional initiator\n
双官能［基］单体  	<br><font color=blue size=4>双官能［基］单体  </font>\n<br>bifunctional monomer\n
双烯单体  	<br><font color=blue size=4>双烯单体  </font>\n<br>diene monomer\n
双烯聚合物  	<br><font color=blue size=4>双烯聚合物  </font>\n<br>diene polymer\n
双烯［类］聚合  	<br><font color=blue size=4>双烯［类］聚合  </font>\n<br>diene polymerization\n
双组分催化剂  	<br><font color=blue size=4>双组分催化剂  </font>\n<br>bicomponent catalyst\n
双股聚合物  	<br><font color=blue size=4>双股聚合物  </font>\n<br>double-strand polymer\n
双[股]螺旋  	<br><font color=blue size=4>双[股]螺旋  </font>\n<br>double stranded helix\n
双轴取向  	<br><font color=blue size=4>双轴取向  </font>\n<br>biaxial orientation, biorientation\n
双轴拉伸  	<br><font color=blue size=4>双轴拉伸  </font>\n<br>biaxial drawing\n
双酚A环氧树脂  	<br><font color=blue size=4>双酚A环氧树脂  </font>\n<br>bisphenol A epoxy resin\n
双酚A聚碳酸酯  	<br><font color=blue size=4>双酚A聚碳酸酯  </font>\n<br>bisphenol A polycarbonate\n
双金属催化剂  	<br><font color=blue size=4>双金属催化剂  </font>\n<br>bimetallic catalyst\n
杂同立构聚合物  	<br><font color=blue size=4>杂同立构聚合物  </font>\n<br>heterotactic polymer\n
杂环高分子  	<br><font color=blue size=4>杂环高分子  </font>\n<br>heterocyclic polymer\n
杂聚物  	<br><font color=blue size=4>杂聚物  </font>\n<br>heteropolymer\n
杂链聚合物  	<br><font color=blue size=4>杂链聚合物  </font>\n<br>heterochain polymer\n
离子交换树脂  	<br><font color=blue size=4>离子交换树脂  </font>\n<br>ion exchange resin\n
离子交换聚合物  	<br><font color=blue size=4>离子交换聚合物  </font>\n<br>ion exchange polymer\n
离子交联聚合物  	<br><font color=blue size=4>离子交联聚合物  </font>\n<br>ionomer\n
离子共聚合  	<br><font color=blue size=4>离子共聚合  </font>\n<br>ionic copolymerization\n
离子对聚合  	<br><font color=blue size=4>离子对聚合  </font>\n<br>ion pair polymerization\n
离子聚合  	<br><font color=blue size=4>离子聚合  </font>\n<br>ionic polymerization\n
离子聚合物  	<br><font color=blue size=4>离子聚合物  </font>\n<br>ionic polymer\n
零切变速率黏度  	<br><font color=blue size=4>零切变速率黏度  </font>\n<br>zero shear viscosity\n
电活性聚合物  	<br><font color=blue size=4>电活性聚合物  </font>\n<br>electroactive polymer\n
电流变液  	<br><font color=blue size=4>电流变液  </font>\n<br>electrorheological fluid\n
电致发光聚合物  	<br><font color=blue size=4>电致发光聚合物  </font>\n<br>electroluminescent polymer\n
电致变色聚合物  	<br><font color=blue size=4>电致变色聚合物  </font>\n<br>electrochromic polymer\n
电荷转移引发  	<br><font color=blue size=4>电荷转移引发  </font>\n<br>charge transfer initiation\n
电荷转移聚合  	<br><font color=blue size=4>电荷转移聚合  </font>\n<br>charge transfer polymerization\n
电荷转移复合物  	<br><font color=blue size=4>电荷转移复合物  </font>\n<br>charge transfer complex, CTC\n
电解聚合  	<br><font color=blue size=4>电解聚合  </font>\n<br>electrolytic polymerization\n
静电纺丝  	<br><font color=blue size=4>静电纺丝  </font>\n<br>electrostatic spinning\n
非共轭单体  	<br><font color=blue size=4>非共轭单体  </font>\n<br>non conjugated monomer\n
非均相聚合  	<br><font color=blue size=4>非均相聚合  </font>\n<br>heterogeneous polymerization\n
非晶区  	<br><font color=blue size=4>非晶区  </font>\n<br>amorphous region\n
非晶取向  	<br><font color=blue size=4>非晶取向  </font>\n<br>amorphous orientation\n
非晶态  	<br><font color=blue size=4>非晶态  </font>\n<br>amorphous state\n
非晶相  	<br><font color=blue size=4>非晶相  </font>\n<br>amorphous phase\n
非极性单体  	<br><font color=blue size=4>非极性单体  </font>\n<br>non polar monomer\n
非极性聚合物  	<br><font color=blue size=4>非极性聚合物  </font>\n<br>non-polar polymer\n
非牛顿流体  	<br><font color=blue size=4>非牛顿流体  </font>\n<br>non-Newtonian fluid\n
非线性黏弹性  	<br><font color=blue size=4>非线性黏弹性  </font>\n<br>non-linear viscoelasticity\n
非规整嵌段  	<br><font color=blue size=4>非规整嵌段  </font>\n<br>irregular block\n
非规整聚合物  	<br><font color=blue size=4>非规整聚合物  </font>\n<br>irregular polymer\n
顺丁橡胶  	<br><font color=blue size=4>顺丁橡胶  </font>\n<br>cis-1,4-polybutadiene rubber\n
顺式有规聚合物  	<br><font color=blue size=4>顺式有规聚合物  </font>\n<br>cistactic polymer\n
顺［式］-1,4-聚丁二烯  	<br><font color=blue size=4>顺［式］-1,4-聚丁二烯  </font>\n<br>cis-1,4-polybutadiene\n
顺［式］-1,4-聚异戊二烯  	<br><font color=blue size=4>顺［式］-1,4-聚异戊二烯  </font>\n<br>cis-1,4-polyisoprene\n
预发颗粒  	<br><font color=blue size=4>预发颗粒  </font>\n<br>pre-expanded bead\n
预聚合  	<br><font color=blue size=4>预聚合  </font>\n<br>prepolymerization\n
预聚物  	<br><font color=blue size=4>预聚物  </font>\n<br>prepolymer\n
头-尾聚合物  	<br><font color=blue size=4>头-尾聚合物  </font>\n<br>head-to-tail polymer\n
头-头聚合物  	<br><font color=blue size=4>头-头聚合物  </font>\n<br>head-to-head polymer\n
颈缩现象  	<br><font color=blue size=4>颈缩现象  </font>\n<br>necking, 又称“细颈现象”\n
类酶高分子  	<br><font color=blue size=4>类酶高分子  </font>\n<br>enzyme like polymer\n
饱和橡胶  	<br><font color=blue size=4>饱和橡胶  </font>\n<br>saturated rubber\n
饱和聚酯  	<br><font color=blue size=4>饱和聚酯  </font>\n<br>saturated polyester\n
骨胶原  	<br><font color=blue size=4>骨胶原  </font>\n<br>collagen\n
体型缩聚  	<br><font color=blue size=4>体型缩聚  </font>\n<br>three dimensional polycondensation\n
体型聚合物  	<br><font color=blue size=4>体型聚合物  </font>\n<br>three-dimensional polymer\n
体积弛豫  	<br><font color=blue size=4>体积弛豫  </font>\n<br>volume relaxation\n
高分子  	<br><font color=blue size=4>高分子  </font>\n<br>macromolecule, polymer\n
高分子催化剂  	<br><font color=blue size=4>高分子催化剂  </font>\n<br>polymer catalyst\n
高分子共混物  	<br><font color=blue size=4>高分子共混物  </font>\n<br>polyblend, polymer blend\n
高分子半导体  	<br><font color=blue size=4>高分子半导体  </font>\n<br>semiconducting polymer\n
高分子微晶  	<br><font color=blue size=4>高分子微晶  </font>\n<br>polymer crystallite\n
高分子晶体  	<br><font color=blue size=4>高分子晶体  </font>\n<br>polymer crystal\n
高分子添加剂  	<br><font color=blue size=4>高分子添加剂  </font>\n<br>polymeric additive\n
高分子[异质]同晶现象  	<br><font color=blue size=4>高分子[异质]同晶现象  </font>\n<br>macromolecular isomorphism\n
高分子絮凝剂  	<br><font color=blue size=4>高分子絮凝剂  </font>\n<br>polymeric flocculant\n
高分子膜  	<br><font color=blue size=4>高分子膜  </font>\n<br>polymeric membrane\n
高分子胶体  	<br><font color=blue size=4>高分子胶体  </font>\n<br>polymer colloid\n
高分子药物  	<br><font color=blue size=4>高分子药物  </font>\n<br>polymer drug\n
高分子试剂  	<br><font color=blue size=4>高分子试剂  </font>\n<br>polymer reactant, polymer reagent\n
高分子载体  	<br><font color=blue size=4>高分子载体  </font>\n<br>polymeric carrier, polymer support\n
高分子离子  	<br><font color=blue size=4>高分子离子  </font>\n<br>macroion\n
高分子电解质  	<br><font color=blue size=4>高分子电解质  </font>\n<br>polymer elec-trolyte\n
高压纺丝  	<br><font color=blue size=4>高压纺丝  </font>\n<br>high-pressure spinning\n
高密度聚乙烯  	<br><font color=blue size=4>高密度聚乙烯  </font>\n<br>high density polyethylene, HDPE\n
高弹形变  	<br><font color=blue size=4>高弹形变  </font>\n<br>high elastic deformation\n
高弹态  	<br><font color=blue size=4>高弹态  </font>\n<br>elastomeric state\n
高弹体  	<br><font color=blue size=4>高弹体  </font>\n<br>elastomer\n
高性能高分子  	<br><font color=blue size=4>高性能高分子  </font>\n<br>high performance polymer\n
高抗冲聚苯乙烯  	<br><font color=blue size=4>高抗冲聚苯乙烯  </font>\n<br>high impact polystyrene, HIPS\n
高斯链  	<br><font color=blue size=4>高斯链  </font>\n<br>Gaussian chain\n
高模量聚合物  	<br><font color=blue size=4>高模量聚合物  </font>\n<br>high modulus polymer\n
高熔聚合物  	<br><font color=blue size=4>高熔聚合物  </font>\n<br>dystectic polymer\n
高聚物  	<br><font color=blue size=4>高聚物  </font>\n<br>high polymer\n
卤化丁基橡胶  	<br><font color=blue size=4>卤化丁基橡胶  </font>\n<br>halogenated butyl rubber\n
麦克斯韦模型  	<br><font color=blue size=4>麦克斯韦模型  </font>\n<br>Maxwell model\n
黄原胶  	<br><font color=blue size=4>黄原胶  </font>\n<br>xanthate gum\n
黏均分子量  	<br><font color=blue size=4>黏均分子量  </font>\n<br>viscosity-average molecular weight，viscosity-average molar mass\n
黏度函数  	<br><font color=blue size=4>黏度函数  </font>\n<br>viscosity function\n
黏度比  	<br><font color=blue size=4>黏度比  </font>\n<br>viscosity ratio\n
黏弹性  	<br><font color=blue size=4>黏弹性  </font>\n<br>viscoelasticity\n
黏数  	<br><font color=blue size=4>黏数  </font>\n<br>viscosity number\n
黏流态  	<br><font color=blue size=4>黏流态  </font>\n<br>viscous flow state\n
齐姆图  	<br><font color=blue size=4>齐姆图  </font>\n<br>Zimm plot\n
齐格勒-纳塔催化剂  	<br><font color=blue size=4>齐格勒-纳塔催化剂  </font>\n<br>Ziegler Natta catalyst\n
齐格勒-纳塔聚合  	<br><font color=blue size=4>齐格勒-纳塔聚合  </font>\n<br>Ziegler Natta polymerization\n
齐聚反应  	<br><font color=blue size=4>齐聚反应  </font>\n<br>oligomerization(曾用名)\n
齐聚物  	<br><font color=blue size=4>齐聚物  </font>\n<br>oligomer (曾用名)\n
龟裂  	<br><font color=blue size=4>龟裂  </font>\n<br>crack (俗称)\n
